Hour,DayOfWeekNum,CarCount,BikeCount,BusCount,TruckCount,Total,TrafficSituationEncoded,Traffic Situation
0,1,13,2,2,24,41,3,normal
0,1,14,1,1,36,52,3,normal
0,1,10,2,2,32,46,3,normal
0,1,10,2,2,36,50,3,normal
1,1,11,2,1,34,48,3,normal
1,1,15,1,1,39,56,3,normal
1,1,14,2,2,27,45,3,normal
1,1,13,2,1,20,36,3,normal
2,1,7,0,0,26,33,3,normal
2,1,13,0,0,34,47,3,normal
2,1,15,2,0,38,55,3,normal
2,1,5,2,0,37,44,3,normal
3,1,9,1,0,34,44,3,normal
3,1,8,0,2,35,45,3,normal
3,1,7,0,0,34,41,3,normal
3,1,10,1,2,38,51,3,normal
4,1,82,7,3,10,102,2,low
4,1,71,3,0,30,104,3,normal
4,1,89,10,2,10,111,2,low
4,1,77,3,0,18,98,2,low
5,1,90,2,0,22,114,3,normal
5,1,84,1,7,23,115,3,normal
5,1,88,8,6,10,112,3,normal
5,1,97,27,15,8,147,3,normal
6,1,107,10,24,11,152,3,normal
6,1,82,26,11,5,124,3,normal
6,1,93,16,24,10,143,3,normal
6,1,128,18,14,6,166,3,normal
7,1,110,19,12,14,155,3,normal
7,1,122,13,10,5,150,3,normal
7,1,92,14,16,12,134,3,normal
7,1,143,30,17,12,202,0,heavy
8,1,134,18,21,11,184,0,heavy
8,1,134,30,15,14,193,0,heavy
8,1,119,13,14,13,159,3,normal
8,1,139,12,22,13,186,0,heavy
9,1,73,9,14,17,113,3,normal
9,1,33,12,9,6,60,2,low
9,1,69,9,26,9,113,1,high
9,1,69,12,10,5,96,2,low
10,1,55,11,9,17,92,2,low
10,1,32,7,27,12,78,3,normal
10,1,53,13,7,5,78,2,low
10,1,34,10,9,35,88,3,normal
11,1,32,10,10,26,78,3,normal
11,1,47,10,5,25,87,3,normal
11,1,28,0,5,29,62,3,normal
11,1,35,7,13,34,89,3,normal
12,1,38,10,8,31,87,3,normal
12,1,32,3,12,35,82,3,normal
12,1,54,5,12,29,100,3,normal
12,1,52,2,12,29,95,3,normal
13,1,68,19,18,30,135,3,normal
13,1,73,15,3,17,108,2,low
13,1,21,18,18,23,80,3,normal
13,1,63,11,16,11,101,3,normal
14,1,7,17,20,18,62,3,normal
14,1,76,15,32,17,140,1,high
14,1,59,14,18,28,119,3,normal
14,1,90,9,3,14,116,3,normal
15,1,5,13,4,20,42,3,normal
15,1,33,18,22,23,96,3,normal
15,1,39,19,13,23,94,3,normal
15,1,150,21,10,14,195,0,heavy
16,1,126,27,40,19,212,0,heavy
16,1,144,7,35,17,203,0,heavy
16,1,145,13,12,18,188,0,heavy
16,1,121,29,27,15,192,0,heavy
17,1,150,21,37,19,227,0,heavy
17,1,122,8,10,11,151,3,normal
17,1,129,20,35,18,202,0,heavy
17,1,114,7,39,19,179,0,heavy
18,1,109,10,26,17,162,1,high
18,1,101,22,24,18,165,3,normal
18,1,91,13,8,12,124,3,normal
18,1,90,17,10,11,128,3,normal
19,1,107,2,15,35,159,1,high
19,1,66,7,5,22,100,3,normal
19,1,98,5,7,30,140,3,normal
19,1,91,10,17,28,146,3,normal
20,1,82,4,9,20,115,3,normal
20,1,65,10,19,18,112,3,normal
20,1,54,3,20,15,92,3,normal
20,1,78,6,16,35,135,1,high
21,1,70,20,10,33,133,1,high
21,1,90,9,11,11,121,3,normal
21,1,96,0,19,23,138,3,normal
21,1,14,1,0,27,42,3,normal
22,1,7,1,0,36,44,3,normal
22,1,9,0,2,35,46,3,normal
22,1,7,0,0,34,41,3,normal
22,1,11,0,1,33,45,3,normal
23,1,11,2,2,40,55,3,normal
23,1,11,1,0,31,43,3,normal
23,1,9,2,1,20,32,3,normal
23,1,8,1,2,31,42,3,normal
0,2,9,1,2,29,41,3,normal
0,2,12,2,1,32,47,3,normal
0,2,11,2,1,33,47,3,normal
0,2,7,0,0,29,36,3,normal
1,2,5,1,2,21,29,3,normal
1,2,13,1,2,20,36,3,normal
1,2,7,1,0,40,48,3,normal
1,2,13,2,2,30,47,3,normal
2,2,10,0,2,35,47,3,normal
2,2,15,2,2,32,51,3,normal
2,2,8,2,2,26,38,3,normal
2,2,11,0,0,28,39,3,normal
3,2,7,0,1,36,44,3,normal
3,2,8,0,1,32,41,3,normal
3,2,15,1,0,35,51,3,normal
3,2,9,1,0,33,43,3,normal
4,2,72,7,2,14,95,2,low
4,2,64,7,7,20,98,3,normal
4,2,85,8,5,14,112,3,normal
4,2,73,6,6,15,100,2,low
5,2,57,0,0,15,72,2,low
5,2,81,4,4,24,113,3,normal
5,2,54,6,3,18,81,2,low
5,2,97,22,23,12,154,3,normal
6,2,109,10,14,13,146,3,normal
6,2,102,23,23,11,159,3,normal
6,2,135,13,18,6,172,0,heavy
6,2,105,12,13,9,139,3,normal
7,2,90,17,19,8,134,3,normal
7,2,104,14,19,7,144,3,normal
7,2,134,20,24,8,186,0,heavy
7,2,120,26,17,8,171,0,heavy
8,2,142,19,16,5,182,0,heavy
8,2,121,28,20,15,184,0,heavy
8,2,85,26,17,9,137,3,normal
8,2,140,15,14,12,181,0,heavy
9,2,68,12,29,12,121,1,high
9,2,56,7,14,15,92,2,low
9,2,33,14,12,19,78,3,normal
9,2,61,9,18,6,94,3,normal
10,2,36,10,24,14,84,3,normal
10,2,57,13,22,19,111,3,normal
10,2,64,9,20,19,112,3,normal
10,2,30,7,1,31,69,3,normal
11,2,54,10,10,28,102,3,normal
11,2,28,5,12,29,74,3,normal
11,2,50,2,4,30,86,3,normal
11,2,60,4,3,26,93,3,normal
12,2,39,4,4,30,77,3,normal
12,2,32,1,12,27,72,3,normal
12,2,59,3,12,28,102,3,normal
12,2,64,9,9,25,107,3,normal
13,2,52,17,17,21,107,3,normal
13,2,96,14,3,22,135,3,normal
13,2,61,8,21,24,114,3,normal
13,2,100,7,11,22,140,3,normal
14,2,6,8,32,24,70,3,normal
14,2,88,14,32,26,160,1,high
14,2,27,14,15,23,79,3,normal
14,2,22,15,21,10,68,3,normal
15,2,53,5,17,21,96,3,normal
15,2,61,11,27,22,121,1,high
15,2,74,13,5,26,118,3,normal
15,2,121,7,16,20,164,3,normal
16,2,110,9,37,13,169,0,heavy
16,2,116,12,39,12,179,0,heavy
16,2,100,27,39,13,179,0,heavy
16,2,118,11,28,11,168,0,heavy
17,2,137,14,13,13,177,0,heavy
17,2,130,23,14,18,185,0,heavy
17,2,146,13,10,18,187,0,heavy
17,2,114,23,19,11,167,3,normal
18,2,104,18,15,15,152,3,normal
18,2,114,24,31,10,179,0,heavy
18,2,90,0,18,11,119,3,normal
18,2,95,2,9,15,121,3,normal
19,2,60,4,7,28,99,3,normal
19,2,72,1,9,32,114,1,high
19,2,92,20,11,31,154,1,high
19,2,70,18,9,23,120,3,normal
20,2,97,8,17,10,132,3,normal
20,2,72,11,5,24,112,3,normal
20,2,60,12,20,28,120,3,normal
20,2,62,7,7,13,89,2,low
21,2,79,19,13,17,128,3,normal
21,2,92,9,15,19,135,3,normal
21,2,62,1,5,10,78,2,low
21,2,13,0,1,39,53,3,normal
22,2,15,2,1,24,42,3,normal
22,2,12,2,2,22,38,3,normal
22,2,5,0,0,36,41,3,normal
22,2,11,1,2,26,40,3,normal
23,2,6,1,2,28,37,3,normal
23,2,6,0,1,27,34,3,normal
23,2,10,0,2,33,45,3,normal
23,2,5,0,1,27,33,3,normal
0,3,6,1,2,37,46,3,normal
0,3,5,2,1,36,44,3,normal
0,3,6,1,0,26,33,3,normal
0,3,9,2,0,21,32,3,normal
1,3,11,2,2,35,50,3,normal
1,3,8,2,0,34,44,3,normal
1,3,14,2,0,35,51,3,normal
1,3,8,0,0,36,44,3,normal
2,3,10,1,0,21,32,3,normal
2,3,14,0,1,35,50,3,normal
2,3,8,1,0,21,30,3,normal
2,3,12,2,1,37,52,3,normal
3,3,15,2,1,30,48,3,normal
3,3,12,2,1,33,48,3,normal
3,3,8,0,2,38,48,3,normal
3,3,10,1,2,39,52,3,normal
4,3,90,5,0,28,123,3,normal
4,3,57,9,0,15,81,2,low
4,3,61,5,0,11,77,2,low
4,3,84,10,6,16,116,3,normal
5,3,59,8,5,18,90,2,low
5,3,64,5,3,27,99,3,normal
5,3,72,3,5,10,90,2,low
5,3,102,12,14,7,135,3,normal
6,3,132,16,23,9,180,0,heavy
6,3,114,11,25,7,157,3,normal
6,3,117,18,22,12,169,0,heavy
6,3,149,15,10,15,189,0,heavy
7,3,103,29,12,6,150,3,normal
7,3,81,30,16,5,132,3,normal
7,3,140,14,12,12,178,0,heavy
7,3,88,25,23,5,141,3,normal
8,3,146,17,20,6,189,0,heavy
8,3,148,16,25,6,195,0,heavy
8,3,125,21,22,11,179,0,heavy
8,3,88,30,23,5,146,3,normal
9,3,67,14,24,19,124,3,normal
9,3,56,12,30,16,114,1,high
9,3,75,9,15,19,118,3,normal
9,3,52,8,5,12,77,2,low
10,3,40,9,25,12,86,3,normal
10,3,46,7,30,13,96,3,normal
10,3,76,6,8,14,104,2,low
10,3,62,6,6,25,99,3,normal
11,3,63,8,9,27,107,3,normal
11,3,39,2,12,25,78,3,normal
11,3,55,7,4,35,101,3,normal
11,3,64,9,8,34,115,1,high
12,3,56,1,5,27,89,3,normal
12,3,43,3,4,35,85,3,normal
12,3,52,0,3,30,85,3,normal
12,3,25,7,4,33,69,3,normal
13,3,47,13,0,18,78,2,low
13,3,26,16,31,26,99,3,normal
13,3,86,3,9,30,128,3,normal
13,3,46,6,21,11,84,3,normal
14,3,66,13,3,26,108,3,normal
14,3,89,19,21,18,147,3,normal
14,3,88,1,10,21,120,3,normal
14,3,88,8,8,24,128,3,normal
15,3,96,20,28,14,158,1,high
15,3,70,1,20,16,107,3,normal
15,3,79,3,14,22,118,3,normal
15,3,133,6,21,15,175,0,heavy
16,3,128,11,38,14,191,0,heavy
16,3,123,27,34,13,197,0,heavy
16,3,129,23,17,16,185,0,heavy
16,3,104,22,40,11,177,0,heavy
17,3,128,9,19,14,170,0,heavy
17,3,130,10,38,11,189,0,heavy
17,3,146,14,35,15,210,0,heavy
17,3,120,22,32,17,191,0,heavy
18,3,102,25,31,14,172,0,heavy
18,3,116,11,18,18,163,3,normal
18,3,83,19,15,22,139,3,normal
18,3,67,10,11,24,112,3,normal
19,3,98,5,9,25,137,3,normal
19,3,61,2,11,31,105,3,normal
19,3,80,14,5,15,114,3,normal
19,3,59,5,6,11,81,2,low
20,3,68,14,20,10,112,3,normal
20,3,84,15,12,16,127,3,normal
20,3,67,19,16,17,119,3,normal
20,3,53,14,19,33,119,1,high
21,3,50,1,6,20,77,3,normal
21,3,64,0,9,32,105,3,normal
21,3,70,4,5,24,103,3,normal
21,3,5,0,0,38,43,3,normal
22,3,11,2,0,38,51,3,normal
22,3,11,1,1,40,53,3,normal
22,3,12,1,2,31,46,3,normal
22,3,5,1,0,36,42,3,normal
23,3,5,0,0,23,28,3,normal
23,3,6,0,2,26,34,3,normal
23,3,15,1,2,20,38,3,normal
23,3,6,2,0,24,32,3,normal
0,4,6,1,2,40,49,3,normal
0,4,6,1,0,39,46,3,normal
0,4,15,1,2,23,41,3,normal
0,4,7,1,2,35,45,3,normal
1,4,15,0,0,22,37,3,normal
1,4,11,2,2,33,48,3,normal
1,4,14,2,1,24,41,3,normal
1,4,5,2,2,36,45,3,normal
2,4,9,0,2,35,46,3,normal
2,4,14,0,0,30,44,3,normal
2,4,5,0,0,29,34,3,normal
2,4,9,0,1,36,46,3,normal
3,4,15,1,2,36,54,3,normal
3,4,11,1,0,20,32,3,normal
3,4,14,1,2,29,46,3,normal
3,4,5,0,1,38,44,3,normal
4,4,54,7,2,27,90,3,normal
4,4,52,5,2,54,113,1,high
4,4,64,7,3,59,133,1,high
4,4,28,7,4,35,74,3,normal
5,4,79,2,2,48,131,1,high
5,4,58,0,3,35,96,3,normal
5,4,43,4,0,48,95,3,normal
5,4,72,5,3,57,137,1,high
6,4,63,0,0,43,106,3,normal
6,4,58,10,1,58,127,1,high
6,4,25,2,3,26,56,3,normal
6,4,26,6,2,56,90,3,normal
7,4,53,5,5,25,88,3,normal
7,4,34,6,1,34,75,3,normal
7,4,27,3,5,53,88,3,normal
7,4,77,0,3,44,124,1,high
8,4,65,10,1,52,128,1,high
8,4,65,6,3,55,129,1,high
8,4,78,6,2,35,121,1,high
8,4,36,6,5,57,104,3,normal
9,4,144,42,11,7,204,0,heavy
9,4,125,29,19,6,179,0,heavy
9,4,114,50,6,8,178,0,heavy
9,4,136,24,20,6,186,0,heavy
10,4,114,37,19,7,177,0,heavy
10,4,141,50,16,5,212,0,heavy
10,4,117,50,20,10,197,0,heavy
10,4,103,40,11,9,163,3,normal
11,4,131,39,5,5,180,0,heavy
11,4,119,22,6,8,155,3,normal
11,4,104,35,19,9,167,3,normal
11,4,146,24,13,6,189,0,heavy
12,4,134,26,14,6,180,0,heavy
12,4,111,46,19,8,184,0,heavy
12,4,106,37,19,8,170,0,heavy
12,4,128,36,12,9,185,0,heavy
13,4,101,36,11,9,157,3,normal
13,4,142,21,7,9,179,0,heavy
13,4,124,21,10,5,160,3,normal
13,4,103,22,20,7,152,3,normal
14,4,139,47,7,8,201,0,heavy
14,4,127,28,20,10,185,0,heavy
14,4,126,39,13,7,185,0,heavy
14,4,100,41,15,8,164,3,normal
15,4,66,5,5,17,93,2,low
15,4,83,13,9,10,115,3,normal
15,4,50,6,15,9,80,2,low
15,4,50,13,1,11,75,2,low
16,4,65,5,1,20,91,3,normal
16,4,72,8,12,19,111,3,normal
16,4,80,7,0,9,96,2,low
16,4,71,5,10,5,91,2,low
17,4,83,11,2,12,108,2,low
17,4,54,5,6,10,75,2,low
17,4,55,6,4,10,75,2,low
17,4,56,15,14,5,90,2,low
18,4,71,8,13,12,104,2,low
18,4,59,5,13,18,95,2,low
18,4,62,14,4,10,90,2,low
18,4,68,10,9,20,107,3,normal
19,4,27,0,3,40,70,3,normal
19,4,45,3,1,44,93,3,normal
19,4,23,3,1,39,66,3,normal
19,4,50,4,4,40,98,3,normal
20,4,29,2,4,39,74,3,normal
20,4,26,1,5,30,62,3,normal
20,4,43,4,5,39,91,3,normal
20,4,33,5,0,25,63,3,normal
21,4,21,2,4,30,57,3,normal
21,4,47,2,4,40,93,3,normal
21,4,24,4,4,41,73,3,normal
21,4,11,0,2,27,40,3,normal
22,4,5,1,1,37,44,3,normal
22,4,14,2,1,22,39,3,normal
22,4,6,2,0,39,47,3,normal
22,4,15,2,2,37,56,3,normal
23,4,9,2,2,36,49,3,normal
23,4,11,0,0,34,45,3,normal
23,4,13,1,2,25,41,3,normal
23,4,13,1,2,31,47,3,normal
0,5,10,0,0,37,47,3,normal
0,5,6,2,0,20,28,3,normal
0,5,12,1,1,36,50,3,normal
0,5,9,2,0,27,38,3,normal
1,5,13,1,0,35,49,3,normal
1,5,7,0,1,40,48,3,normal
1,5,6,1,1,37,45,3,normal
1,5,8,1,1,27,37,3,normal
2,5,9,2,2,30,43,3,normal
2,5,7,1,0,38,46,3,normal
2,5,6,0,1,35,42,3,normal
2,5,7,0,2,27,36,3,normal
3,5,5,0,0,36,41,3,normal
3,5,11,2,2,25,40,3,normal
3,5,5,1,2,22,30,3,normal
3,5,14,0,1,30,45,3,normal
4,5,55,1,1,30,87,3,normal
4,5,74,10,1,10,95,2,low
4,5,89,7,1,21,118,3,normal
4,5,87,9,6,17,119,3,normal
5,5,80,10,3,19,112,3,normal
5,5,89,7,0,25,121,3,normal
5,5,89,6,6,17,118,3,normal
5,5,134,12,20,5,171,0,heavy
6,5,104,16,11,15,146,3,normal
6,5,132,10,20,13,175,0,heavy
6,5,112,16,18,12,158,3,normal
6,5,84,25,11,15,135,3,normal
7,5,101,25,21,15,162,3,normal
7,5,141,16,25,10,192,0,heavy
7,5,108,29,23,11,171,0,heavy
7,5,147,27,25,7,206,0,heavy
8,5,102,10,18,12,142,3,normal
8,5,141,30,19,7,197,0,heavy
8,5,118,23,19,15,175,0,heavy
8,5,90,27,12,10,139,3,normal
9,5,35,5,25,11,76,3,normal
9,5,80,11,8,19,118,3,normal
9,5,71,15,7,10,103,2,low
9,5,58,5,5,7,75,2,low
10,5,36,5,15,19,75,3,normal
10,5,36,15,22,11,84,3,normal
10,5,30,12,20,17,79,3,normal
10,5,29,5,11,29,74,3,normal
11,5,34,8,10,25,77,3,normal
11,5,61,3,6,31,101,3,normal
11,5,52,7,5,27,91,3,normal
11,5,24,0,12,34,70,3,normal
12,5,28,9,5,25,67,3,normal
12,5,42,0,4,33,79,3,normal
12,5,31,4,9,26,70,3,normal
12,5,29,2,4,34,69,3,normal
13,5,64,19,22,13,118,3,normal
13,5,84,1,11,16,112,3,normal
13,5,20,0,17,24,61,3,normal
13,5,82,16,32,22,152,1,high
14,5,80,14,22,25,141,3,normal
14,5,18,16,10,14,58,2,low
14,5,57,12,30,15,114,1,high
14,5,50,1,21,25,97,3,normal
15,5,6,4,5,10,25,2,low
15,5,78,19,30,23,150,1,high
15,5,38,8,18,30,94,3,normal
15,5,129,18,12,17,176,0,heavy
16,5,114,9,39,11,173,0,heavy
16,5,139,8,40,17,204,0,heavy
16,5,108,20,10,15,153,3,normal
16,5,129,11,12,20,172,0,heavy
17,5,149,22,31,13,215,0,heavy
17,5,120,27,37,12,196,0,heavy
17,5,120,6,37,18,181,0,heavy
17,5,124,28,32,18,202,0,heavy
18,5,116,10,28,19,173,0,heavy
18,5,100,9,10,11,130,3,normal
18,5,88,8,20,33,149,1,high
18,5,94,16,15,20,145,3,normal
19,5,94,17,19,35,165,1,high
19,5,51,20,7,25,103,3,normal
19,5,58,12,20,19,109,3,normal
19,5,74,8,10,13,105,2,low
20,5,92,9,11,32,144,1,high
20,5,92,5,17,12,126,3,normal
20,5,50,9,18,18,95,3,normal
20,5,80,11,14,14,119,3,normal
21,5,102,10,13,13,138,3,normal
21,5,68,13,18,13,112,3,normal
21,5,108,4,17,13,142,3,normal
21,5,13,1,2,20,36,3,normal
22,5,8,0,2,34,44,3,normal
22,5,11,2,2,40,55,3,normal
22,5,13,1,1,28,43,3,normal
22,5,12,0,2,23,37,3,normal
23,5,9,0,1,20,30,3,normal
23,5,8,1,2,21,32,3,normal
23,5,7,1,1,26,35,3,normal
23,5,6,0,1,22,29,3,normal
0,6,11,2,0,35,48,3,normal
0,6,7,2,0,24,33,3,normal
0,6,7,2,2,28,39,3,normal
0,6,13,0,2,24,39,3,normal
1,6,13,1,2,27,43,3,normal
1,6,7,1,1,32,41,3,normal
1,6,7,0,2,24,33,3,normal
1,6,6,2,0,25,33,3,normal
2,6,5,0,0,26,31,3,normal
2,6,6,0,2,20,28,3,normal
2,6,10,2,1,35,48,3,normal
2,6,14,1,0,22,37,3,normal
3,6,13,1,1,24,39,3,normal
3,6,13,1,1,23,38,3,normal
3,6,15,0,0,39,54,3,normal
3,6,9,2,2,25,38,3,normal
4,6,76,7,2,14,99,2,low
4,6,75,4,4,23,106,3,normal
4,6,54,8,0,16,78,2,low
4,6,60,5,6,25,96,3,normal
5,6,70,4,6,21,101,3,normal
5,6,70,10,7,24,111,3,normal
5,6,50,2,3,26,81,3,normal
5,6,128,11,25,13,177,0,heavy
6,6,131,23,15,11,180,0,heavy
6,6,140,24,17,8,189,0,heavy
6,6,113,23,23,10,169,0,heavy
6,6,109,22,13,8,152,3,normal
7,6,143,11,11,12,177,0,heavy
7,6,137,24,25,8,194,0,heavy
7,6,109,27,14,8,158,3,normal
7,6,87,30,17,8,142,3,normal
8,6,91,14,13,5,123,3,normal
8,6,86,15,16,14,131,3,normal
8,6,134,13,24,11,182,0,heavy
8,6,137,13,20,9,179,0,heavy
9,6,47,15,26,15,103,3,normal
9,6,52,8,23,17,100,3,normal
9,6,77,5,5,14,101,2,low
9,6,43,13,24,14,94,3,normal
10,6,68,14,30,19,131,1,high
10,6,46,5,11,13,75,2,low
10,6,80,11,5,16,112,3,normal
10,6,43,8,1,27,79,3,normal
11,6,66,7,12,27,112,3,normal
11,6,34,0,2,33,69,3,normal
11,6,65,2,8,30,105,3,normal
11,6,59,7,9,29,104,3,normal
12,6,55,7,4,28,94,3,normal
12,6,41,4,9,35,89,3,normal
12,6,32,0,8,25,65,3,normal
12,6,48,2,12,30,92,3,normal
13,6,36,16,12,13,77,2,low
13,6,43,2,23,22,90,3,normal
13,6,13,3,24,30,70,3,normal
13,6,90,20,22,18,150,3,normal
14,6,98,4,20,28,150,3,normal
14,6,95,6,27,14,142,1,high
14,6,39,13,8,11,71,2,low
14,6,54,15,8,11,88,2,low
15,6,28,19,13,11,71,2,low
15,6,7,4,5,23,39,3,normal
15,6,29,18,9,15,71,2,low
15,6,122,18,18,19,177,0,heavy
16,6,150,30,14,17,211,0,heavy
16,6,113,25,28,12,178,0,heavy
16,6,116,23,39,17,195,0,heavy
16,6,127,14,40,11,192,0,heavy
17,6,116,15,33,20,184,0,heavy
17,6,136,15,15,18,184,0,heavy
17,6,120,17,14,11,162,3,normal
17,6,109,25,35,12,181,0,heavy
18,6,134,21,26,15,196,0,heavy
18,6,135,10,36,15,196,0,heavy
18,6,77,1,10,25,113,3,normal
18,6,107,15,13,11,146,3,normal
19,6,106,16,5,19,146,3,normal
19,6,52,17,5,16,90,2,low
19,6,100,19,5,22,146,3,normal
19,6,107,13,13,22,155,3,normal
20,6,67,7,20,33,127,1,high
20,6,100,15,10,11,136,3,normal
20,6,110,1,18,20,149,3,normal
20,6,92,14,10,11,127,3,normal
21,6,109,14,16,14,153,3,normal
21,6,85,17,11,28,141,3,normal
21,6,101,12,16,12,141,3,normal
21,6,10,0,0,25,35,3,normal
22,6,12,2,1,32,47,3,normal
22,6,13,2,0,40,55,3,normal
22,6,15,1,0,30,46,3,normal
22,6,6,1,0,34,41,3,normal
23,6,11,1,1,39,52,3,normal
23,6,9,2,1,23,35,3,normal
23,6,10,2,2,28,42,3,normal
23,6,12,0,1,38,51,3,normal
0,0,11,2,2,39,54,3,normal
0,0,7,1,0,29,37,3,normal
0,0,15,0,2,33,50,3,normal
0,0,10,0,0,20,30,3,normal
1,0,6,0,1,40,47,3,normal
1,0,12,1,2,31,46,3,normal
1,0,15,0,0,26,41,3,normal
1,0,10,0,1,31,42,3,normal
2,0,9,0,2,38,49,3,normal
2,0,9,2,2,37,50,3,normal
2,0,7,0,0,34,41,3,normal
2,0,12,2,1,26,41,3,normal
3,0,15,0,0,34,49,3,normal
3,0,11,0,1,29,41,3,normal
3,0,9,1,1,30,41,3,normal
3,0,5,2,0,28,35,3,normal
4,0,70,1,0,25,96,3,normal
4,0,74,0,6,25,105,3,normal
4,0,81,3,1,20,105,3,normal
4,0,71,2,4,21,98,3,normal
5,0,75,7,1,28,111,3,normal
5,0,88,5,5,25,123,3,normal
5,0,71,2,4,19,96,3,normal
5,0,115,10,11,15,151,3,normal
6,0,147,26,11,5,189,0,heavy
6,0,102,15,20,10,147,3,normal
6,0,80,12,25,9,126,3,normal
6,0,97,23,25,7,152,3,normal
7,0,81,23,24,8,136,3,normal
7,0,130,16,10,15,171,0,heavy
7,0,103,13,24,13,153,3,normal
7,0,138,22,20,8,188,0,heavy
8,0,128,16,22,12,178,0,heavy
8,0,91,14,11,8,124,3,normal
8,0,141,27,12,9,189,0,heavy
8,0,114,19,25,5,163,3,normal
9,0,53,14,30,10,107,3,normal
9,0,69,9,17,5,100,3,normal
9,0,39,8,16,10,73,3,normal
9,0,71,13,25,8,117,3,normal
10,0,48,8,29,12,97,3,normal
10,0,73,14,18,17,122,3,normal
10,0,61,8,7,18,94,2,low
10,0,44,7,11,30,92,3,normal
11,0,59,0,7,35,101,3,normal
11,0,50,3,5,29,87,3,normal
11,0,26,3,5,28,62,3,normal
11,0,24,7,13,34,78,3,normal
12,0,35,3,3,33,74,3,normal
12,0,59,10,9,25,103,3,normal
12,0,31,2,5,33,71,3,normal
12,0,21,10,7,31,69,3,normal
13,0,68,20,24,14,126,3,normal
13,0,31,4,21,22,78,3,normal
13,0,44,6,18,17,85,3,normal
13,0,39,16,27,26,108,3,normal
14,0,25,19,35,18,97,3,normal
14,0,16,4,29,14,63,3,normal
14,0,8,11,24,12,55,3,normal
14,0,35,18,3,16,72,2,low
15,0,95,16,16,21,148,3,normal
15,0,8,3,32,22,65,3,normal
15,0,30,19,14,18,81,2,low
15,0,125,11,26,11,173,0,heavy
16,0,130,10,30,20,190,0,heavy
16,0,149,27,24,19,219,0,heavy
16,0,107,25,38,14,184,0,heavy
16,0,129,16,23,10,178,0,heavy
17,0,131,7,33,13,184,0,heavy
17,0,124,20,13,14,171,0,heavy
17,0,102,20,17,16,155,3,normal
17,0,144,13,12,20,189,0,heavy
18,0,148,9,37,18,212,0,heavy
18,0,141,11,33,16,201,0,heavy
18,0,96,18,5,30,149,3,normal
18,0,85,7,13,31,136,1,high
19,0,101,0,19,33,153,1,high
19,0,83,1,6,24,114,3,normal
19,0,61,10,13,30,114,3,normal
19,0,101,6,20,27,154,3,normal
20,0,107,0,15,27,149,3,normal
20,0,78,3,12,33,126,1,high
20,0,77,20,7,22,126,3,normal
20,0,108,10,5,21,144,3,normal
21,0,55,0,19,25,99,3,normal
21,0,61,10,14,35,120,1,high
21,0,88,18,7,23,136,3,normal
21,0,7,0,1,38,46,3,normal
22,0,12,0,0,35,47,3,normal
22,0,7,2,1,35,45,3,normal
22,0,14,2,1,21,38,3,normal
22,0,10,1,1,20,32,3,normal
23,0,6,2,0,31,39,3,normal
23,0,5,2,1,40,48,3,normal
23,0,14,0,2,40,56,3,normal
23,0,6,0,2,32,40,3,normal
0,1,14,0,2,27,43,3,normal
0,1,8,1,1,21,31,3,normal
0,1,11,2,2,21,36,3,normal
0,1,10,2,0,33,45,3,normal
1,1,13,1,2,29,45,3,normal
1,1,6,2,0,27,35,3,normal
1,1,7,2,0,22,31,3,normal
1,1,5,2,2,37,46,3,normal
2,1,14,2,1,40,57,3,normal
2,1,14,0,0,31,45,3,normal
2,1,10,0,2,39,51,3,normal
2,1,8,2,0,40,50,3,normal
3,1,15,0,1,35,51,3,normal
3,1,11,1,1,37,50,3,normal
3,1,15,1,2,27,45,3,normal
3,1,15,2,1,40,58,3,normal
4,1,83,9,0,14,106,2,low
4,1,82,3,0,30,115,3,normal
4,1,76,4,6,15,101,2,low
4,1,59,5,2,11,77,2,low
5,1,59,5,3,27,94,3,normal
5,1,71,4,6,17,98,2,low
5,1,70,4,4,23,101,3,normal
5,1,104,11,19,9,143,3,normal
6,1,136,30,11,5,182,0,heavy
6,1,86,13,21,9,129,3,normal
6,1,131,19,18,11,179,0,heavy
6,1,90,16,14,13,133,3,normal
7,1,129,13,17,5,164,3,normal
7,1,91,10,25,14,140,3,normal
7,1,86,10,20,14,130,3,normal
7,1,100,19,17,8,144,3,normal
8,1,84,11,10,11,116,3,normal
8,1,109,29,25,11,174,0,heavy
8,1,93,22,15,8,138,3,normal
8,1,92,17,16,5,130,3,normal
9,1,80,7,11,17,115,3,normal
9,1,30,11,24,7,72,3,normal
9,1,35,14,14,12,75,2,low
9,1,70,5,25,7,107,3,normal
10,1,59,10,7,16,92,2,low
10,1,56,12,7,6,81,2,low
10,1,77,10,5,18,110,2,low
10,1,64,2,10,34,110,3,normal
11,1,37,3,13,28,81,3,normal
11,1,51,6,8,33,98,3,normal
11,1,33,1,9,30,73,3,normal
11,1,70,1,11,31,113,1,high
12,1,39,0,1,26,66,3,normal
12,1,49,4,11,35,99,3,normal
12,1,33,2,0,25,60,3,normal
12,1,49,8,1,32,90,3,normal
13,1,70,2,16,14,102,3,normal
13,1,23,16,20,26,85,3,normal
13,1,17,8,12,10,47,2,low
13,1,37,2,7,29,75,3,normal
14,1,38,1,0,10,49,2,low
14,1,8,17,20,18,63,3,normal
14,1,24,16,29,23,92,3,normal
14,1,11,0,17,26,54,3,normal
15,1,15,3,20,28,66,3,normal
15,1,59,15,31,29,134,1,high
15,1,7,11,17,25,60,3,normal
15,1,116,19,35,11,181,0,heavy
16,1,123,5,31,13,172,0,heavy
16,1,107,16,17,11,151,3,normal
16,1,117,6,17,16,156,3,normal
16,1,102,10,15,11,138,3,normal
17,1,100,12,14,15,141,3,normal
17,1,142,22,25,18,207,0,heavy
17,1,104,19,12,16,151,3,normal
17,1,105,23,17,13,158,3,normal
18,1,101,30,23,18,172,0,heavy
18,1,138,16,14,19,187,0,heavy
18,1,96,5,18,26,145,3,normal
18,1,70,17,20,34,141,1,high
19,1,62,10,15,26,113,3,normal
19,1,101,18,15,15,149,3,normal
19,1,83,1,5,31,120,1,high
19,1,104,20,20,20,164,3,normal
20,1,107,9,6,20,142,3,normal
20,1,100,2,11,23,136,3,normal
20,1,110,2,18,21,151,3,normal
20,1,110,2,14,31,157,1,high
21,1,65,20,14,17,116,3,normal
21,1,53,18,10,35,116,1,high
21,1,65,2,13,33,113,1,high
21,1,14,0,0,26,40,3,normal
22,1,7,1,0,24,32,3,normal
22,1,8,0,0,21,29,3,normal
22,1,15,0,0,32,47,3,normal
22,1,15,2,2,20,39,3,normal
23,1,11,1,0,37,49,3,normal
23,1,5,0,0,37,42,3,normal
23,1,10,2,2,28,42,3,normal
23,1,15,0,2,40,57,3,normal
0,2,11,2,0,39,52,3,normal
0,2,11,2,1,28,42,3,normal
0,2,5,1,1,29,36,3,normal
0,2,7,2,0,27,36,3,normal
1,2,7,2,1,22,32,3,normal
1,2,10,2,1,38,51,3,normal
1,2,6,1,2,25,34,3,normal
1,2,15,2,1,27,45,3,normal
2,2,7,1,0,36,44,3,normal
2,2,14,2,0,38,54,3,normal
2,2,15,2,0,27,44,3,normal
2,2,6,1,1,30,38,3,normal
3,2,7,0,1,24,32,3,normal
3,2,13,0,1,24,38,3,normal
3,2,11,2,2,22,37,3,normal
3,2,13,2,1,36,52,3,normal
4,2,88,6,5,19,118,3,normal
4,2,60,0,6,18,84,2,low
4,2,54,6,6,14,80,2,low
4,2,66,0,2,20,88,3,normal
5,2,68,6,6,11,91,2,low
5,2,89,9,1,14,113,3,normal
5,2,56,1,0,24,81,3,normal
5,2,101,24,15,9,149,3,normal
6,2,120,28,20,10,178,0,heavy
6,2,95,29,18,12,154,3,normal
6,2,94,13,21,11,139,3,normal
6,2,141,30,24,12,207,0,heavy
7,2,144,26,18,13,201,0,heavy
7,2,107,26,22,11,166,3,normal
7,2,118,27,10,12,167,2,low
7,2,136,16,24,10,186,0,heavy
8,2,139,30,21,15,205,0,heavy
8,2,103,19,15,14,151,3,normal
8,2,127,18,11,15,171,0,heavy
8,2,101,29,16,8,154,3,normal
9,2,55,8,20,19,102,3,normal
9,2,56,7,8,14,85,2,low
9,2,34,7,8,9,58,2,low
9,2,57,10,15,12,94,2,low
10,2,44,15,9,18,86,2,low
10,2,43,7,25,11,86,3,normal
10,2,41,9,26,6,82,3,normal
10,2,32,2,6,30,70,3,normal
11,2,38,10,3,32,83,3,normal
11,2,56,10,9,35,110,3,normal
11,2,30,4,11,35,80,3,normal
11,2,66,2,3,26,97,3,normal
12,2,40,10,0,28,78,3,normal
12,2,50,8,8,25,91,3,normal
12,2,26,3,6,26,61,3,normal
12,2,50,8,7,33,98,3,normal
13,2,15,7,12,25,59,3,normal
13,2,57,17,14,28,116,3,normal
13,2,47,10,13,13,83,2,low
13,2,12,4,11,23,50,3,normal
14,2,49,8,4,16,77,2,low
14,2,55,2,35,21,113,1,high
14,2,44,9,10,26,89,3,normal
14,2,73,9,28,17,127,1,high
15,2,36,4,26,12,78,3,normal
15,2,67,1,12,17,97,2,low
15,2,44,16,17,11,88,3,normal
15,2,145,14,35,10,204,0,heavy
16,2,107,10,32,10,159,1,high
16,2,100,17,31,15,163,1,high
16,2,126,20,37,10,193,0,heavy
16,2,147,23,39,13,222,0,heavy
17,2,133,6,18,10,167,3,normal
17,2,147,29,10,18,204,0,heavy
17,2,115,11,27,13,166,1,high
17,2,132,12,19,15,178,0,heavy
18,2,106,23,20,13,162,3,normal
18,2,119,28,37,12,196,0,heavy
18,2,77,18,10,14,119,3,normal
18,2,89,4,11,12,116,3,normal
19,2,106,5,13,17,141,3,normal
19,2,52,11,18,11,92,3,normal
19,2,84,7,9,19,119,3,normal
19,2,84,15,7,27,133,3,normal
20,2,93,0,11,27,131,3,normal
20,2,73,20,14,31,138,1,high
20,2,50,16,5,32,103,3,normal
20,2,66,11,20,29,126,3,normal
21,2,63,8,6,13,90,2,low
21,2,91,20,7,24,142,3,normal
21,2,104,5,12,22,143,3,normal
21,2,6,0,1,27,34,3,normal
22,2,6,2,0,35,43,3,normal
22,2,14,0,0,24,38,3,normal
22,2,15,1,2,27,45,3,normal
22,2,10,0,0,29,39,3,normal
23,2,7,0,2,35,44,3,normal
23,2,7,2,0,30,39,3,normal
23,2,8,2,2,20,32,3,normal
23,2,5,1,2,34,42,3,normal
0,3,7,2,1,31,41,3,normal
0,3,8,0,2,34,44,3,normal
0,3,6,0,1,26,33,3,normal
0,3,5,0,0,25,30,3,normal
1,3,11,1,1,25,38,3,normal
1,3,8,1,2,25,36,3,normal
1,3,15,2,2,38,57,3,normal
1,3,8,0,2,32,42,3,normal
2,3,7,0,0,32,39,3,normal
2,3,14,2,1,22,39,3,normal
2,3,14,2,2,32,50,3,normal
2,3,9,2,2,40,53,3,normal
3,3,5,2,0,29,36,3,normal
3,3,11,1,1,32,45,3,normal
3,3,7,2,2,38,49,3,normal
3,3,7,0,1,33,41,3,normal
4,3,65,9,2,19,95,3,normal
4,3,50,0,7,22,79,3,normal
4,3,61,7,1,14,83,2,low
4,3,77,6,3,28,114,3,normal
5,3,80,7,3,28,118,3,normal
5,3,66,1,4,25,96,3,normal
5,3,89,3,5,21,118,3,normal
5,3,87,25,13,13,138,3,normal
6,3,94,26,24,10,154,3,normal
6,3,116,20,11,11,158,3,normal
6,3,127,20,13,14,174,0,heavy
6,3,130,13,14,13,170,0,heavy
7,3,86,12,13,14,125,3,normal
7,3,116,11,22,14,163,3,normal
7,3,115,13,13,8,149,3,normal
7,3,99,14,24,12,149,3,normal
8,3,86,23,20,13,142,3,normal
8,3,81,25,19,8,133,3,normal
8,3,113,10,15,11,149,3,normal
8,3,147,18,20,5,190,0,heavy
9,3,49,6,26,16,97,3,normal
9,3,79,5,13,19,116,3,normal
9,3,32,5,26,17,80,3,normal
9,3,51,15,9,13,88,2,low
10,3,33,10,25,17,85,3,normal
10,3,49,7,15,6,77,2,low
10,3,54,13,5,6,78,2,low
10,3,28,1,6,32,67,3,normal
11,3,43,0,5,33,81,3,normal
11,3,52,2,12,30,96,3,normal
11,3,25,7,8,25,65,3,normal
11,3,28,8,12,30,78,3,normal
12,3,67,0,1,28,96,3,normal
12,3,58,9,3,26,96,3,normal
12,3,53,1,13,32,99,3,normal
12,3,63,6,7,31,107,3,normal
13,3,42,2,34,27,105,3,normal
13,3,27,8,10,12,57,2,low
13,3,78,5,5,25,113,3,normal
13,3,93,0,5,16,114,3,normal
14,3,66,18,29,10,123,1,high
14,3,42,20,18,22,102,3,normal
14,3,63,3,29,15,110,3,normal
14,3,13,20,9,27,69,3,normal
15,3,55,1,28,16,100,3,normal
15,3,67,4,23,14,108,3,normal
15,3,65,6,0,26,97,3,normal
15,3,141,6,33,12,192,0,heavy
16,3,145,13,19,10,187,0,heavy
16,3,103,29,11,16,159,3,normal
16,3,112,20,10,19,161,3,normal
16,3,101,11,38,18,168,0,heavy
17,3,142,28,34,20,224,0,heavy
17,3,124,21,13,11,169,0,heavy
17,3,115,22,15,19,171,0,heavy
17,3,103,28,17,17,165,3,normal
18,3,104,16,15,18,153,3,normal
18,3,141,20,12,16,189,0,heavy
18,3,72,19,11,23,125,3,normal
18,3,67,10,19,34,130,1,high
19,3,56,7,18,34,115,1,high
19,3,99,13,16,34,162,1,high
19,3,103,19,8,30,160,3,normal
19,3,58,7,9,26,100,3,normal
20,3,59,7,14,28,108,3,normal
20,3,94,20,12,20,146,3,normal
20,3,83,15,16,18,132,3,normal
20,3,89,1,18,14,122,3,normal
21,3,52,13,16,13,94,3,normal
21,3,53,15,5,22,95,3,normal
21,3,60,0,14,11,85,2,low
21,3,10,2,0,37,49,3,normal
22,3,11,1,2,33,47,3,normal
22,3,5,0,0,40,45,3,normal
22,3,11,1,0,31,43,3,normal
22,3,14,2,0,24,40,3,normal
23,3,10,0,2,26,38,3,normal
23,3,13,0,2,36,51,3,normal
23,3,9,1,1,29,40,3,normal
23,3,10,0,2,22,34,3,normal
0,4,13,2,0,26,41,3,normal
0,4,7,2,1,21,31,3,normal
0,4,8,1,0,40,49,3,normal
0,4,10,2,0,20,32,3,normal
1,4,13,0,2,22,37,3,normal
1,4,15,2,1,40,58,3,normal
1,4,10,2,0,23,35,3,normal
1,4,7,0,2,37,46,3,normal
2,4,12,2,0,33,47,3,normal
2,4,9,2,2,23,36,3,normal
2,4,12,1,0,33,46,3,normal
2,4,11,0,0,34,45,3,normal
3,4,12,2,2,22,38,3,normal
3,4,6,0,1,26,33,3,normal
3,4,9,0,1,37,47,3,normal
3,4,6,0,0,21,27,3,normal
4,4,75,0,0,54,129,1,high
4,4,60,9,2,50,121,1,high
4,4,57,1,0,44,102,3,normal
4,4,64,10,5,26,105,3,normal
5,4,73,6,0,53,132,1,high
5,4,62,6,4,39,111,3,normal
5,4,80,2,5,25,112,3,normal
5,4,25,6,5,40,76,3,normal
6,4,73,6,3,43,125,1,high
6,4,78,0,3,53,134,1,high
6,4,32,6,4,27,69,3,normal
6,4,57,5,1,49,112,1,high
7,4,36,2,3,60,101,3,normal
7,4,49,5,5,26,85,3,normal
7,4,70,9,0,28,107,3,normal
7,4,65,6,4,44,119,1,high
8,4,53,8,0,40,101,3,normal
8,4,38,7,1,35,81,3,normal
8,4,68,10,5,55,138,1,high
8,4,69,7,3,25,104,3,normal
9,4,136,49,19,10,214,0,heavy
9,4,128,21,6,5,160,3,normal
9,4,138,37,15,7,197,0,heavy
9,4,142,34,9,10,195,0,heavy
10,4,109,23,19,8,159,3,normal
10,4,103,24,16,10,153,3,normal
10,4,140,34,6,7,187,0,heavy
10,4,100,24,8,5,137,3,normal
11,4,128,24,20,7,179,0,heavy
11,4,124,26,16,5,171,0,heavy
11,4,150,44,13,7,214,0,heavy
11,4,146,21,12,5,184,0,heavy
12,4,146,50,13,9,218,0,heavy
12,4,121,38,19,9,187,0,heavy
12,4,150,42,20,5,217,0,heavy
12,4,101,22,10,10,143,3,normal
13,4,127,22,9,7,165,3,normal
13,4,118,31,13,10,172,0,heavy
13,4,106,47,12,9,174,0,heavy
13,4,136,33,16,5,190,0,heavy
14,4,114,25,20,7,166,3,normal
14,4,135,33,8,9,185,0,heavy
14,4,125,33,12,10,180,0,heavy
14,4,150,45,20,9,224,0,heavy
15,4,85,14,2,9,110,2,low
15,4,62,8,8,15,93,2,low
15,4,68,9,15,15,107,2,low
15,4,54,6,7,16,83,2,low
16,4,70,5,7,14,96,2,low
16,4,77,8,10,6,101,2,low
16,4,90,6,15,17,128,3,normal
16,4,74,13,0,16,103,2,low
17,4,74,9,2,11,96,2,low
17,4,62,5,2,20,89,3,normal
17,4,66,12,8,16,102,2,low
17,4,80,5,11,13,109,2,low
18,4,75,13,15,12,115,3,normal
18,4,77,12,9,20,118,3,normal
18,4,84,10,3,15,112,3,normal
18,4,52,7,2,19,80,3,normal
19,4,32,2,0,32,66,3,normal
19,4,37,4,5,33,79,3,normal
19,4,39,1,5,29,74,3,normal
19,4,34,1,4,35,74,3,normal
20,4,43,3,2,41,89,3,normal
20,4,22,1,4,43,70,3,normal
20,4,43,4,1,27,75,3,normal
20,4,46,1,0,35,82,3,normal
21,4,42,2,5,42,91,3,normal
21,4,20,5,3,39,67,3,normal
21,4,40,5,3,26,74,3,normal
21,4,5,0,2,39,46,3,normal
22,4,13,2,0,20,35,3,normal
22,4,13,2,0,24,39,3,normal
22,4,6,0,1,22,29,3,normal
22,4,6,1,1,34,42,3,normal
23,4,5,0,2,27,34,3,normal
23,4,12,1,2,25,40,3,normal
23,4,11,1,2,35,49,3,normal
23,4,15,2,1,34,52,3,normal
0,5,9,2,1,36,48,3,normal
0,5,12,0,2,32,46,3,normal
0,5,7,2,2,23,34,3,normal
0,5,12,1,1,33,47,3,normal
1,5,5,0,2,30,37,3,normal
1,5,12,1,2,27,42,3,normal
1,5,12,1,1,30,44,3,normal
1,5,15,1,0,34,50,3,normal
2,5,15,2,2,31,50,3,normal
2,5,13,0,1,29,43,3,normal
2,5,6,2,1,27,36,3,normal
2,5,13,0,0,30,43,3,normal
3,5,7,1,0,22,30,3,normal
3,5,8,1,0,28,37,3,normal
3,5,13,0,1,27,41,3,normal
3,5,6,1,0,33,40,3,normal
4,5,66,2,5,13,86,2,low
4,5,86,3,5,22,116,3,normal
4,5,87,4,1,10,102,2,low
4,5,68,3,7,25,103,3,normal
5,5,51,0,2,27,80,3,normal
5,5,70,3,3,15,91,2,low
5,5,74,2,2,26,104,3,normal
5,5,150,30,20,13,213,0,heavy
6,5,89,21,18,8,136,3,normal
6,5,114,18,23,6,161,3,normal
6,5,81,19,18,12,130,3,normal
6,5,94,24,10,13,141,3,normal
7,5,136,12,22,5,175,0,heavy
7,5,125,17,12,8,162,3,normal
7,5,109,16,15,11,151,3,normal
7,5,84,15,25,14,138,3,normal
8,5,138,19,24,6,187,0,heavy
8,5,121,17,10,14,162,3,normal
8,5,125,27,20,14,186,0,heavy
8,5,132,25,14,14,185,0,heavy
9,5,62,6,23,18,109,3,normal
9,5,40,5,5,10,60,2,low
9,5,61,14,23,15,113,3,normal
9,5,36,6,24,20,86,3,normal
10,5,80,8,18,5,111,3,normal
10,5,52,5,15,12,84,2,low
10,5,80,9,19,17,125,3,normal
10,5,69,9,1,25,104,3,normal
11,5,21,9,1,26,57,3,normal
11,5,42,8,3,27,80,3,normal
11,5,55,10,4,30,99,3,normal
11,5,61,10,3,31,105,3,normal
12,5,70,3,7,33,113,1,high
12,5,56,4,13,34,107,3,normal
12,5,50,2,13,33,98,3,normal
12,5,24,5,11,27,67,3,normal
13,5,65,6,14,27,112,3,normal
13,5,74,3,32,27,136,1,high
13,5,33,14,33,28,108,3,normal
13,5,16,20,1,14,51,2,low
14,5,32,9,5,30,76,3,normal
14,5,37,13,23,12,85,3,normal
14,5,63,5,5,30,103,3,normal
14,5,60,12,20,17,109,3,normal
15,5,54,18,22,26,120,3,normal
15,5,82,10,10,17,119,3,normal
15,5,83,19,7,17,126,3,normal
15,5,127,8,18,10,163,3,normal
16,5,136,12,37,18,203,0,heavy
16,5,105,17,34,16,172,0,heavy
16,5,133,14,37,13,197,0,heavy
16,5,132,19,32,17,200,0,heavy
17,5,129,7,22,19,177,0,heavy
17,5,107,12,26,19,164,1,high
17,5,133,16,28,17,194,0,heavy
17,5,114,17,28,18,177,0,heavy
18,5,134,5,27,15,181,0,heavy
18,5,103,14,39,20,176,0,heavy
18,5,68,20,9,22,119,3,normal
18,5,107,10,20,35,172,0,heavy
19,5,81,5,13,23,122,3,normal
19,5,93,17,17,15,142,3,normal
19,5,78,9,7,12,106,2,low
19,5,84,16,14,28,142,3,normal
20,5,79,5,15,16,115,3,normal
20,5,102,16,12,17,147,3,normal
20,5,87,7,5,11,110,2,low
20,5,50,4,9,19,82,3,normal
21,5,95,0,5,11,111,2,low
21,5,65,10,8,29,112,3,normal
21,5,55,8,18,24,105,3,normal
21,5,13,2,2,28,45,3,normal
22,5,6,1,1,31,39,3,normal
22,5,10,1,2,31,44,3,normal
22,5,13,1,1,40,55,3,normal
22,5,14,2,2,30,48,3,normal
23,5,6,1,0,39,46,3,normal
23,5,15,0,2,29,46,3,normal
23,5,8,2,2,24,36,3,normal
23,5,8,0,2,37,47,3,normal
0,6,11,0,1,24,36,3,normal
0,6,8,1,1,27,37,3,normal
0,6,6,1,1,33,41,3,normal
0,6,5,0,2,40,47,3,normal
1,6,8,2,1,35,46,3,normal
1,6,14,0,0,34,48,3,normal
1,6,14,1,1,21,37,3,normal
1,6,6,2,2,38,48,3,normal
2,6,8,2,2,36,48,3,normal
2,6,6,1,1,21,29,3,normal
2,6,6,0,2,40,48,3,normal
2,6,15,1,1,37,54,3,normal
3,6,15,0,1,36,52,3,normal
3,6,10,2,2,31,45,3,normal
3,6,8,1,2,38,49,3,normal
3,6,10,0,1,35,46,3,normal
4,6,58,2,1,19,80,3,normal
4,6,70,4,0,14,88,2,low
4,6,72,8,4,18,102,2,low
4,6,88,8,1,28,125,3,normal
5,6,57,10,4,26,97,3,normal
5,6,61,7,6,24,98,3,normal
5,6,65,6,4,27,102,3,normal
5,6,131,30,19,5,185,0,heavy
6,6,117,21,21,11,170,0,heavy
6,6,145,26,14,9,194,0,heavy
6,6,85,16,16,6,123,3,normal
6,6,92,19,24,5,140,3,normal
7,6,130,19,13,9,171,0,heavy
7,6,84,12,19,15,130,3,normal
7,6,115,17,19,13,164,3,normal
7,6,119,17,15,12,163,3,normal
8,6,99,20,14,14,147,3,normal
8,6,102,30,24,6,162,3,normal
8,6,86,29,10,5,130,3,normal
8,6,128,25,13,10,176,0,heavy
9,6,40,12,20,12,84,3,normal
9,6,56,7,15,12,90,2,low
9,6,46,9,10,15,80,2,low
9,6,49,6,11,14,80,2,low
10,6,62,6,19,15,102,3,normal
10,6,42,6,16,7,71,3,normal
10,6,45,11,5,20,81,3,normal
10,6,21,0,5,27,53,3,normal
11,6,38,7,4,26,75,3,normal
11,6,25,10,12,27,74,3,normal
11,6,36,0,8,28,72,3,normal
11,6,41,7,7,30,85,3,normal
12,6,64,0,1,26,91,3,normal
12,6,62,3,6,29,100,3,normal
12,6,66,10,13,35,124,1,high
12,6,34,5,7,26,72,3,normal
13,6,84,3,0,12,99,2,low
13,6,18,2,30,10,60,3,normal
13,6,40,9,17,25,91,3,normal
13,6,68,18,13,24,123,3,normal
14,6,56,18,22,21,117,3,normal
14,6,28,4,29,17,78,3,normal
14,6,18,0,27,12,57,3,normal
14,6,77,16,33,16,142,1,high
15,6,67,8,32,11,118,1,high
15,6,33,9,33,24,99,3,normal
15,6,77,6,9,18,110,2,low
15,6,104,5,14,15,138,3,normal
16,6,130,17,27,10,184,0,heavy
16,6,149,17,11,19,196,0,heavy
16,6,132,20,39,15,206,0,heavy
16,6,147,24,34,18,223,3,normal
17,6,111,11,14,14,150,3,normal
17,6,136,19,37,14,206,0,heavy
17,6,120,5,34,18,177,0,heavy
17,6,126,16,15,20,177,0,heavy
18,6,125,5,34,18,182,0,heavy
18,6,128,6,13,19,166,3,normal
18,6,99,14,5,30,148,3,normal
18,6,107,20,6,20,153,3,normal
19,6,104,3,12,20,139,3,normal
19,6,61,8,17,10,96,3,normal
19,6,78,10,13,23,124,3,normal
19,6,51,4,8,11,74,2,low
20,6,84,3,20,16,123,3,normal
20,6,99,1,17,12,129,3,normal
20,6,88,20,15,35,158,1,high
20,6,97,4,13,10,124,3,normal
21,6,94,3,5,33,135,1,high
21,6,68,1,13,32,114,1,high
21,6,73,9,19,27,128,3,normal
21,6,10,2,1,28,41,3,normal
22,6,7,1,1,39,48,3,normal
22,6,6,1,2,36,45,3,normal
22,6,15,1,1,26,43,3,normal
22,6,8,0,2,39,49,3,normal
23,6,8,1,1,22,32,3,normal
23,6,5,0,0,28,33,3,normal
23,6,5,2,0,29,36,3,normal
23,6,11,2,1,35,49,3,normal
0,0,15,1,0,37,53,3,normal
0,0,11,0,0,23,34,3,normal
0,0,7,1,2,22,32,3,normal
0,0,14,1,0,36,51,3,normal
1,0,12,2,2,36,52,3,normal
1,0,6,1,1,38,46,3,normal
1,0,8,2,1,34,45,3,normal
1,0,14,0,2,32,48,3,normal
2,0,6,1,1,21,29,3,normal
2,0,13,1,2,36,52,3,normal
2,0,9,2,0,39,50,3,normal
2,0,6,1,1,37,45,3,normal
3,0,8,2,1,27,38,3,normal
3,0,7,1,2,23,33,3,normal
3,0,5,1,1,21,28,3,normal
3,0,5,2,1,35,43,3,normal
4,0,63,10,5,13,91,2,low
4,0,72,3,2,13,90,2,low
4,0,56,5,7,24,92,3,normal
4,0,83,0,6,14,103,2,low
5,0,88,0,2,15,105,2,low
5,0,55,9,2,14,80,2,low
5,0,86,1,4,11,102,2,low
5,0,81,25,12,5,123,3,normal
6,0,104,18,14,9,145,3,normal
6,0,101,30,22,15,168,0,heavy
6,0,123,30,20,8,181,0,heavy
6,0,94,30,24,8,156,3,normal
7,0,142,10,16,8,176,0,heavy
7,0,108,11,22,8,149,3,normal
7,0,100,25,19,5,149,3,normal
7,0,84,25,24,5,138,3,normal
8,0,125,19,23,7,174,0,heavy
8,0,111,27,25,5,168,0,heavy
8,0,110,21,23,5,159,3,normal
8,0,94,26,20,15,155,3,normal
9,0,55,10,5,8,78,2,low
9,0,78,11,7,16,112,3,normal
9,0,50,11,13,15,89,2,low
9,0,63,14,27,14,118,1,high
10,0,76,11,9,17,113,3,normal
10,0,56,6,26,5,93,3,normal
10,0,32,13,8,11,64,2,low
10,0,47,7,8,29,91,3,normal
11,0,30,9,0,31,70,3,normal
11,0,46,2,4,31,83,3,normal
11,0,52,2,5,29,88,3,normal
11,0,20,3,12,29,64,3,normal
12,0,47,2,10,28,87,3,normal
12,0,28,10,11,34,83,3,normal
12,0,54,2,11,26,93,3,normal
12,0,20,6,1,34,61,3,normal
13,0,53,13,7,15,88,2,low
13,0,30,5,31,18,84,3,normal
13,0,72,15,6,10,103,2,low
13,0,69,5,35,23,132,1,high
14,0,38,15,8,15,76,2,low
14,0,41,8,5,14,68,2,low
14,0,8,8,29,30,75,3,normal
14,0,9,20,3,27,59,3,normal
15,0,58,9,24,18,109,3,normal
15,0,99,10,10,10,129,3,normal
15,0,40,18,9,20,87,3,normal
15,0,118,9,29,18,174,0,heavy
16,0,104,27,15,10,156,3,normal
16,0,131,29,15,18,193,0,heavy
16,0,128,14,22,20,184,0,heavy
16,0,110,18,19,14,161,3,normal
17,0,116,26,22,18,182,0,heavy
17,0,140,26,31,16,213,0,heavy
17,0,141,27,23,16,207,0,heavy
17,0,147,17,20,19,203,0,heavy
18,0,137,23,25,10,195,0,heavy
18,0,115,18,24,20,177,0,heavy
18,0,83,3,12,27,125,3,normal
18,0,55,9,5,10,79,2,low
19,0,99,16,14,35,164,1,high
19,0,57,16,8,26,107,3,normal
19,0,65,11,17,28,121,3,normal
19,0,52,1,14,35,102,3,normal
20,0,60,8,9,27,104,3,normal
20,0,109,17,9,17,152,3,normal
20,0,71,6,20,33,130,1,high
20,0,105,12,17,31,165,1,high
21,0,72,18,18,25,133,3,normal
21,0,107,8,6,25,146,3,normal
21,0,86,13,14,20,133,3,normal
21,0,5,2,1,35,43,3,normal
22,0,13,2,1,40,56,3,normal
22,0,13,0,2,33,48,3,normal
22,0,14,2,2,27,45,3,normal
22,0,7,2,1,27,37,3,normal
23,0,14,2,2,28,46,3,normal
23,0,7,1,0,29,37,3,normal
23,0,9,1,0,36,46,3,normal
23,0,7,1,0,27,35,3,normal
0,1,9,2,1,26,38,3,normal
0,1,14,1,2,34,51,3,normal
0,1,13,2,2,21,38,3,normal
0,1,6,0,0,21,27,3,normal
1,1,5,1,1,28,35,3,normal
1,1,14,0,0,31,45,3,normal
1,1,8,0,1,39,48,3,normal
1,1,6,2,2,24,34,3,normal
2,1,9,1,0,33,43,3,normal
2,1,11,1,2,40,54,3,normal
2,1,15,0,2,22,39,3,normal
2,1,5,2,0,39,46,3,normal
3,1,8,1,0,39,48,3,normal
3,1,9,2,2,31,44,3,normal
3,1,6,2,1,31,40,3,normal
3,1,6,2,0,39,47,3,normal
4,1,78,0,2,17,97,2,low
4,1,77,7,6,28,118,3,normal
4,1,72,3,2,29,106,3,normal
4,1,87,2,3,21,113,3,normal
5,1,50,5,2,17,74,2,low
5,1,79,9,5,14,107,2,low
5,1,58,1,5,20,84,3,normal
5,1,94,12,16,8,130,3,normal
6,1,114,23,23,9,169,0,heavy
6,1,94,24,23,6,147,3,normal
6,1,137,14,13,13,177,0,heavy
6,1,80,17,24,10,131,3,normal
7,1,90,14,10,9,123,3,normal
7,1,105,10,14,15,144,3,normal
7,1,104,17,23,5,149,3,normal
7,1,135,30,17,10,192,0,heavy
8,1,118,25,18,9,170,0,heavy
8,1,96,13,21,6,136,3,normal
8,1,142,13,11,10,176,0,heavy
8,1,128,30,15,14,187,0,heavy
9,1,80,11,22,9,122,3,normal
9,1,79,13,21,15,128,3,normal
9,1,34,5,29,8,76,3,normal
9,1,58,14,5,5,82,2,low
10,1,42,6,23,17,88,3,normal
10,1,63,9,19,18,109,3,normal
10,1,62,9,18,12,101,3,normal
10,1,44,7,11,32,94,3,normal
11,1,49,4,5,29,87,3,normal
11,1,67,10,1,33,111,3,normal
11,1,68,5,0,34,107,3,normal
11,1,23,5,10,32,70,3,normal
12,1,69,5,2,33,109,3,normal
12,1,37,9,2,34,82,3,normal
12,1,24,1,6,30,61,3,normal
12,1,60,1,4,29,94,3,normal
13,1,59,10,29,18,116,1,high
13,1,69,4,20,14,107,3,normal
13,1,7,11,1,12,31,2,low
13,1,20,13,16,10,59,3,normal
14,1,61,16,1,14,92,2,low
14,1,42,17,11,30,100,3,normal
14,1,28,11,32,14,85,3,normal
14,1,30,14,29,23,96,3,normal
15,1,36,1,24,21,82,3,normal
15,1,82,4,9,24,119,3,normal
15,1,72,2,27,16,117,1,high
15,1,119,28,17,18,182,0,heavy
16,1,124,26,26,15,191,0,heavy
16,1,123,27,23,13,186,0,heavy
16,1,129,20,32,20,201,0,heavy
16,1,143,6,38,13,200,0,heavy
17,1,109,9,28,19,165,1,high
17,1,119,29,25,11,184,0,heavy
17,1,120,19,16,16,171,0,heavy
17,1,133,24,17,18,192,0,heavy
18,1,132,23,29,13,197,0,heavy
18,1,102,11,15,18,146,3,normal
18,1,73,8,10,21,112,3,normal
18,1,57,17,13,21,108,3,normal
19,1,94,17,7,17,135,3,normal
19,1,75,18,17,29,139,3,normal
19,1,58,15,17,16,106,3,normal
19,1,67,18,11,23,119,3,normal
20,1,59,14,9,10,92,2,low
20,1,78,4,11,17,110,2,low
20,1,106,13,18,29,166,3,normal
20,1,56,20,6,32,114,1,high
21,1,59,0,11,35,105,3,normal
21,1,75,19,13,32,139,1,high
21,1,85,6,5,21,117,3,normal
21,1,14,2,2,22,40,3,normal
22,1,8,2,0,22,32,3,normal
22,1,15,2,0,20,37,3,normal
22,1,8,1,1,38,48,3,normal
22,1,14,2,0,23,39,3,normal
23,1,15,1,2,35,53,3,normal
23,1,14,2,1,31,48,3,normal
23,1,9,1,0,32,42,3,normal
23,1,12,1,0,24,37,3,normal
0,2,11,1,2,29,43,3,normal
0,2,7,0,1,27,35,3,normal
0,2,14,0,2,35,51,3,normal
0,2,10,1,1,38,50,3,normal
1,2,10,1,0,27,38,3,normal
1,2,13,0,1,34,48,3,normal
1,2,13,1,1,20,35,3,normal
1,2,15,1,0,32,48,3,normal
2,2,7,0,0,32,39,3,normal
2,2,13,0,2,37,52,3,normal
2,2,8,0,0,39,47,3,normal
2,2,11,1,2,37,51,3,normal
3,2,11,0,0,37,48,3,normal
3,2,10,1,2,26,39,3,normal
3,2,15,1,1,36,53,3,normal
3,2,9,0,2,34,45,3,normal
4,2,60,3,6,23,92,3,normal
4,2,51,7,3,22,83,3,normal
4,2,60,7,2,27,96,3,normal
4,2,65,0,3,25,93,3,normal
5,2,66,4,1,21,92,3,normal
5,2,63,3,5,30,101,3,normal
5,2,72,7,2,20,101,3,normal
5,2,124,16,21,8,169,0,heavy
6,2,106,17,22,14,159,3,normal
6,2,91,24,10,15,140,3,normal
6,2,120,10,18,10,158,3,normal
6,2,147,20,25,8,200,0,heavy
7,2,126,30,19,8,183,0,heavy
7,2,102,19,22,9,152,3,normal
7,2,87,15,25,14,141,3,normal
7,2,118,24,17,15,174,0,heavy
8,2,144,18,16,5,183,0,heavy
8,2,85,12,23,7,127,3,normal
8,2,81,23,19,12,135,3,normal
8,2,121,16,25,9,171,0,heavy
9,2,36,14,17,6,73,3,normal
9,2,80,15,24,11,130,3,normal
9,2,53,12,22,8,95,3,normal
9,2,74,7,8,20,109,3,normal
10,2,53,11,17,13,94,3,normal
10,2,56,6,10,9,81,2,low
10,2,66,14,18,13,111,3,normal
10,2,68,10,5,31,114,1,high
11,2,24,1,10,29,64,3,normal
11,2,52,4,10,31,97,3,normal
11,2,35,5,12,34,86,3,normal
11,2,47,1,5,33,86,3,normal
12,2,36,6,2,35,79,3,normal
12,2,61,7,5,26,99,3,normal
12,2,57,10,2,35,104,3,normal
12,2,64,10,9,29,112,3,normal
13,2,31,16,23,10,80,3,normal
13,2,91,2,0,11,104,2,low
13,2,16,12,26,24,78,3,normal
13,2,58,18,13,25,114,3,normal
14,2,86,16,12,16,130,3,normal
14,2,81,8,20,12,121,3,normal
14,2,6,9,14,29,58,3,normal
14,2,26,0,9,19,54,3,normal
15,2,23,15,7,12,57,2,low
15,2,79,5,15,13,112,3,normal
15,2,11,7,10,29,57,3,normal
15,2,134,22,29,11,196,0,heavy
16,2,128,23,24,16,191,0,heavy
16,2,106,22,19,18,165,3,normal
16,2,124,11,30,18,183,0,heavy
16,2,134,10,13,19,176,0,heavy
17,2,125,17,10,16,168,0,heavy
17,2,147,18,13,11,189,0,heavy
17,2,100,10,20,16,146,3,normal
17,2,146,17,25,11,199,0,heavy
18,2,142,15,34,10,201,0,heavy
18,2,130,24,23,10,187,0,heavy
18,2,94,15,15,32,156,1,high
18,2,104,7,6,19,136,3,normal
19,2,93,10,19,26,148,3,normal
19,2,51,8,13,17,89,2,low
19,2,97,7,7,26,137,3,normal
19,2,93,16,16,28,153,3,normal
20,2,105,17,17,12,151,3,normal
20,2,66,12,20,31,129,1,high
20,2,56,16,20,28,120,3,normal
20,2,109,20,8,13,150,3,normal
21,2,64,8,14,20,106,3,normal
21,2,83,6,6,35,130,1,high
21,2,107,16,14,26,163,3,normal
21,2,5,1,0,28,34,3,normal
22,2,5,2,1,20,28,3,normal
22,2,12,1,2,38,53,3,normal
22,2,6,0,1,24,31,3,normal
22,2,5,1,2,21,29,3,normal
23,2,15,2,1,31,49,3,normal
23,2,5,0,0,31,36,3,normal
23,2,8,0,1,29,38,3,normal
23,2,12,1,1,36,50,3,normal
0,3,14,1,2,36,53,3,normal
0,3,11,2,2,26,41,3,normal
0,3,8,2,2,29,41,3,normal
0,3,10,1,2,36,49,3,normal
1,3,12,1,1,30,44,3,normal
1,3,6,1,0,25,32,3,normal
1,3,7,1,1,21,30,3,normal
1,3,5,2,2,20,29,3,normal
2,3,9,2,0,21,32,3,normal
2,3,5,1,2,35,43,3,normal
2,3,14,0,2,28,44,3,normal
2,3,12,1,1,39,53,3,normal
3,3,7,0,0,29,36,3,normal
3,3,10,2,0,22,34,3,normal
3,3,13,1,1,22,37,3,normal
3,3,15,1,1,39,56,3,normal
4,3,79,3,1,14,97,2,low
4,3,58,3,2,18,81,2,low
4,3,60,8,5,23,96,3,normal
4,3,89,1,0,29,119,3,normal
5,3,64,4,0,12,80,2,low
5,3,62,5,3,26,96,3,normal
5,3,79,7,7,11,104,2,low
5,3,92,12,19,8,131,3,normal
6,3,111,27,12,13,163,3,normal
6,3,105,25,24,11,165,3,normal
6,3,84,26,12,11,133,3,normal
6,3,130,19,20,11,180,0,heavy
7,3,107,16,16,9,148,3,normal
7,3,130,15,11,15,171,0,heavy
7,3,139,28,17,5,189,0,heavy
7,3,91,17,25,14,147,3,normal
8,3,139,22,16,5,182,0,heavy
8,3,141,11,19,7,178,0,heavy
8,3,116,29,14,12,171,0,heavy
8,3,80,17,20,13,130,3,normal
9,3,59,10,23,19,111,3,normal
9,3,76,15,25,5,121,3,normal
9,3,42,10,15,7,74,2,low
9,3,31,5,27,10,73,3,normal
10,3,40,12,26,11,89,3,normal
10,3,72,15,7,19,113,3,normal
10,3,37,8,15,15,75,2,low
10,3,54,6,0,27,87,3,normal
11,3,21,0,1,25,47,3,normal
11,3,70,9,6,30,115,3,normal
11,3,38,3,2,33,76,3,normal
11,3,23,0,1,32,56,3,normal
12,3,38,5,11,33,87,3,normal
12,3,57,9,1,31,98,3,normal
12,3,20,3,3,27,53,3,normal
12,3,42,6,9,33,90,3,normal
13,3,47,11,21,15,94,3,normal
13,3,67,8,22,22,119,3,normal
13,3,70,8,28,13,119,1,high
13,3,53,7,32,11,103,3,normal
14,3,14,19,25,30,88,3,normal
14,3,85,16,26,26,153,1,high
14,3,84,11,34,14,143,1,high
14,3,59,14,33,12,118,1,high
15,3,94,3,12,14,123,3,normal
15,3,81,18,25,12,136,3,normal
15,3,91,12,10,25,138,3,normal
15,3,107,23,13,11,154,3,normal
16,3,137,20,30,15,202,0,heavy
16,3,121,14,32,10,177,0,heavy
16,3,115,26,33,19,193,0,heavy
16,3,133,25,19,12,189,0,heavy
17,3,110,10,29,17,166,1,high
17,3,110,20,24,17,171,0,heavy
17,3,111,26,14,15,166,3,normal
17,3,113,20,38,17,188,0,heavy
18,3,134,13,29,15,191,0,heavy
18,3,148,14,21,19,202,0,heavy
18,3,92,15,18,18,143,3,normal
18,3,71,2,17,10,100,3,normal
19,3,61,0,17,25,103,3,normal
19,3,85,6,11,25,127,3,normal
19,3,79,11,8,16,114,3,normal
19,3,80,17,11,17,125,3,normal
20,3,95,5,7,22,129,3,normal
20,3,108,1,15,25,149,3,normal
20,3,55,20,11,25,111,3,normal
20,3,56,8,19,27,110,3,normal
21,3,57,14,6,34,111,3,normal
21,3,90,11,10,27,138,3,normal
21,3,109,20,6,18,153,3,normal
21,3,11,2,2,39,54,3,normal
22,3,13,1,1,25,40,3,normal
22,3,5,2,1,26,34,3,normal
22,3,5,1,1,33,40,3,normal
22,3,7,2,0,37,46,3,normal
23,3,10,2,1,32,45,3,normal
23,3,11,0,0,26,37,3,normal
23,3,10,0,1,37,48,3,normal
23,3,13,1,1,21,36,3,normal
0,4,5,2,2,32,41,3,normal
0,4,14,1,1,33,49,3,normal
0,4,10,0,0,30,40,3,normal
0,4,15,0,1,38,54,3,normal
1,4,11,2,0,34,47,3,normal
1,4,8,2,0,39,49,3,normal
1,4,8,2,1,40,51,3,normal
1,4,10,1,2,33,46,3,normal
2,4,13,1,2,37,53,3,normal
2,4,5,1,0,38,44,3,normal
2,4,10,1,1,30,42,3,normal
2,4,6,1,2,23,32,3,normal
3,4,6,2,2,22,32,3,normal
3,4,6,2,0,30,38,3,normal
3,4,9,2,0,37,48,3,normal
3,4,11,2,2,34,49,3,normal
4,4,31,0,4,57,92,3,normal
4,4,29,2,4,37,72,3,normal
4,4,76,0,5,40,121,1,high
4,4,51,6,5,57,119,1,high
5,4,69,1,0,51,121,1,high
5,4,42,7,2,47,98,3,normal
5,4,42,10,1,47,100,3,normal
5,4,38,8,2,57,105,3,normal
6,4,25,9,3,39,76,3,normal
6,4,72,0,4,36,112,1,high
6,4,78,8,5,37,128,1,high
6,4,45,7,0,35,87,3,normal
7,4,75,6,2,42,125,1,high
7,4,77,7,1,57,142,1,high
7,4,34,3,2,47,86,3,normal
7,4,49,4,2,58,113,1,high
8,4,40,4,2,57,103,3,normal
8,4,44,9,5,56,114,1,high
8,4,70,0,2,26,98,3,normal
8,4,63,7,0,52,122,1,high
9,4,126,21,7,6,160,3,normal
9,4,117,38,11,9,175,0,heavy
9,4,101,41,17,9,168,0,heavy
9,4,125,35,19,7,186,0,heavy
10,4,147,43,10,7,207,0,heavy
10,4,140,22,18,5,185,0,heavy
10,4,142,44,6,6,198,0,heavy
10,4,147,45,8,10,210,0,heavy
11,4,137,26,14,8,185,0,heavy
11,4,129,40,13,5,187,0,heavy
11,4,131,30,9,8,178,0,heavy
11,4,107,40,6,6,159,3,normal
12,4,102,37,16,7,162,3,normal
12,4,122,46,15,8,191,0,heavy
12,4,116,30,15,7,168,0,heavy
12,4,136,28,20,9,193,0,heavy
13,4,138,34,15,10,197,0,heavy
13,4,131,21,9,9,170,0,heavy
13,4,129,39,16,5,189,0,heavy
13,4,118,50,18,5,191,0,heavy
14,4,140,40,8,6,194,0,heavy
14,4,137,29,10,9,185,0,heavy
14,4,121,46,5,6,178,0,heavy
14,4,120,25,10,6,161,3,normal
15,4,72,10,13,17,112,3,normal
15,4,83,11,9,16,119,3,normal
15,4,67,6,12,19,104,3,normal
15,4,75,8,7,8,98,2,low
16,4,60,10,6,5,81,2,low
16,4,57,13,2,12,84,2,low
16,4,77,13,7,12,109,2,low
16,4,64,11,0,9,84,2,low
17,4,85,12,12,19,128,3,normal
17,4,88,5,2,5,100,2,low
17,4,83,14,4,18,119,3,normal
17,4,64,6,1,13,84,2,low
18,4,62,9,0,18,89,2,low
18,4,69,8,0,15,92,2,low
18,4,84,15,5,18,122,3,normal
18,4,70,6,9,8,93,2,low
19,4,30,0,1,30,61,3,normal
19,4,29,3,3,30,65,3,normal
19,4,27,0,1,33,61,3,normal
19,4,41,3,3,40,87,3,normal
20,4,29,3,1,35,68,3,normal
20,4,38,0,1,28,67,3,normal
20,4,29,2,1,27,59,3,normal
20,4,39,4,0,36,79,3,normal
21,4,27,1,5,31,64,3,normal
21,4,42,5,5,26,78,3,normal
21,4,31,1,3,38,73,3,normal
21,4,7,0,0,35,42,3,normal
22,4,13,0,1,40,54,3,normal
22,4,11,2,2,25,40,3,normal
22,4,11,0,0,31,42,3,normal
22,4,6,2,2,23,33,3,normal
23,4,5,2,2,26,35,3,normal
23,4,13,1,2,26,42,3,normal
23,4,13,1,2,39,55,3,normal
23,4,14,2,2,28,46,3,normal
0,5,5,0,2,39,46,3,normal
0,5,5,1,1,40,47,3,normal
0,5,13,2,1,38,54,3,normal
0,5,9,1,0,29,39,3,normal
1,5,11,0,1,27,39,3,normal
1,5,8,0,2,33,43,3,normal
1,5,9,0,2,40,51,3,normal
1,5,12,1,0,37,50,3,normal
2,5,7,2,2,23,34,3,normal
2,5,14,1,1,29,45,3,normal
2,5,13,1,2,38,54,3,normal
2,5,11,2,2,37,52,3,normal
3,5,10,2,2,26,40,3,normal
3,5,12,0,2,21,35,3,normal
3,5,12,2,1,21,36,3,normal
3,5,6,2,1,38,47,3,normal
4,5,72,6,1,25,104,3,normal
4,5,77,5,6,20,108,3,normal
4,5,89,10,0,16,115,3,normal
4,5,86,1,6,28,121,3,normal
5,5,64,1,0,27,92,3,normal
5,5,55,3,1,27,86,3,normal
5,5,59,0,6,16,81,2,low
5,5,135,13,24,6,178,0,heavy
6,5,138,21,19,10,188,0,heavy
6,5,80,10,17,13,120,3,normal
6,5,148,24,14,10,196,0,heavy
6,5,84,25,21,10,140,3,normal
7,5,103,19,15,6,143,3,normal
7,5,119,13,10,9,151,3,normal
7,5,110,16,21,8,155,3,normal
7,5,130,18,20,13,181,0,heavy
8,5,105,27,23,10,165,3,normal
8,5,103,30,22,12,167,3,normal
8,5,150,12,16,10,188,0,heavy
8,5,132,15,17,14,178,0,heavy
9,5,47,6,15,9,77,2,low
9,5,71,10,6,10,97,2,low
9,5,49,10,12,8,79,2,low
9,5,43,6,21,5,75,3,normal
10,5,74,15,29,15,133,1,high
10,5,30,6,26,18,80,3,normal
10,5,38,15,17,15,85,3,normal
10,5,59,2,8,25,94,3,normal
11,5,51,8,5,25,89,3,normal
11,5,26,9,11,29,75,3,normal
11,5,55,7,8,33,103,3,normal
11,5,43,4,0,32,79,3,normal
12,5,64,1,7,35,107,3,normal
12,5,63,8,13,27,111,3,normal
12,5,42,8,3,26,79,3,normal
12,5,30,7,10,32,79,3,normal
13,5,13,20,1,20,54,3,normal
13,5,59,19,16,23,117,3,normal
13,5,57,14,21,19,111,3,normal
13,5,74,11,23,19,127,3,normal
14,5,33,3,27,23,86,3,normal
14,5,7,6,12,20,45,3,normal
14,5,38,7,1,13,59,2,low
14,5,6,9,10,27,52,3,normal
15,5,54,6,18,23,101,3,normal
15,5,45,16,28,18,107,3,normal
15,5,44,3,0,23,70,3,normal
15,5,144,21,10,19,194,0,heavy
16,5,144,24,26,14,208,0,heavy
16,5,112,26,38,12,188,0,heavy
16,5,106,9,31,11,157,1,high
16,5,149,27,33,16,225,0,heavy
17,5,120,30,17,19,186,0,heavy
17,5,133,15,10,10,168,0,heavy
17,5,108,14,38,19,179,0,heavy
17,5,141,24,11,19,195,0,heavy
18,5,127,15,21,17,180,0,heavy
18,5,134,20,38,20,212,0,heavy
18,5,95,16,15,24,150,3,normal
18,5,71,4,14,30,119,3,normal
19,5,70,7,7,10,94,2,low
19,5,55,13,10,33,111,3,normal
19,5,74,19,12,35,140,1,high
19,5,57,4,15,29,105,3,normal
20,5,59,11,5,21,96,3,normal
20,5,85,8,14,15,122,3,normal
20,5,74,20,17,24,135,3,normal
20,5,88,19,7,27,141,3,normal
21,5,64,18,13,17,112,3,normal
21,5,80,18,14,11,123,3,normal
21,5,108,7,11,25,151,3,normal
21,5,14,1,0,28,43,3,normal
22,5,7,1,1,33,42,3,normal
22,5,5,1,2,31,39,3,normal
22,5,11,2,0,36,49,3,normal
22,5,14,2,1,40,57,3,normal
23,5,6,0,1,21,28,3,normal
23,5,7,0,2,36,45,3,normal
23,5,12,2,1,20,35,3,normal
23,5,8,2,2,39,51,3,normal
0,6,5,1,0,35,41,3,normal
0,6,5,2,1,21,29,3,normal
0,6,10,0,2,33,45,3,normal
0,6,12,0,0,35,47,3,normal
1,6,11,0,2,37,50,3,normal
1,6,6,0,0,29,35,3,normal
1,6,15,2,1,38,56,3,normal
1,6,13,1,2,20,36,3,normal
2,6,11,2,2,39,54,3,normal
2,6,6,1,0,39,46,3,normal
2,6,6,0,1,28,35,3,normal
2,6,15,2,1,37,55,3,normal
3,6,11,2,2,24,39,3,normal
3,6,5,0,0,21,26,3,normal
3,6,8,0,0,20,28,3,normal
3,6,8,1,2,29,40,3,normal
4,6,54,8,7,16,85,2,low
4,6,64,0,1,25,90,3,normal
4,6,55,2,6,24,87,3,normal
4,6,86,4,5,20,115,3,normal
5,6,51,10,3,28,92,3,normal
5,6,81,8,5,12,106,2,low
5,6,73,1,3,23,100,3,normal
5,6,104,29,19,13,165,3,normal
6,6,122,17,21,9,169,0,heavy
6,6,94,21,15,7,137,3,normal
6,6,141,30,22,11,204,0,heavy
6,6,93,12,25,7,137,3,normal
7,6,123,29,13,7,172,0,heavy
7,6,131,27,19,15,192,0,heavy
7,6,138,25,20,14,197,0,heavy
7,6,148,20,14,11,193,0,heavy
8,6,93,12,14,13,132,3,normal
8,6,125,22,12,12,171,0,heavy
8,6,109,26,16,9,160,3,normal
8,6,99,25,15,12,151,3,normal
9,6,78,6,29,14,127,1,high
9,6,63,6,21,9,99,3,normal
9,6,36,11,25,8,80,3,normal
9,6,69,5,23,16,113,3,normal
10,6,67,13,15,17,112,3,normal
10,6,34,12,28,11,85,3,normal
10,6,71,6,12,19,108,3,normal
10,6,22,9,0,31,62,3,normal
11,6,54,4,10,35,103,3,normal
11,6,27,8,13,35,83,3,normal
11,6,36,2,7,27,72,3,normal
11,6,29,9,13,28,79,3,normal
12,6,65,3,12,25,105,3,normal
12,6,66,5,7,35,113,1,high
12,6,23,4,5,30,62,3,normal
12,6,42,10,2,25,79,3,normal
13,6,55,5,33,20,113,1,high
13,6,18,5,15,21,59,3,normal
13,6,22,13,17,22,74,3,normal
13,6,59,18,18,23,118,3,normal
14,6,63,16,3,13,95,2,low
14,6,66,3,25,12,106,3,normal
14,6,75,4,3,15,97,2,low
14,6,92,7,35,25,159,1,high
15,6,40,14,16,28,98,3,normal
15,6,39,2,8,19,68,3,normal
15,6,43,11,16,20,90,3,normal
15,6,128,26,25,12,191,0,heavy
16,6,150,24,30,12,216,0,heavy
16,6,108,6,37,18,169,0,heavy
16,6,111,17,40,18,186,0,heavy
16,6,112,24,39,16,191,0,heavy
17,6,140,10,38,18,206,0,heavy
17,6,144,13,15,14,186,0,heavy
17,6,127,17,24,17,185,0,heavy
17,6,100,8,13,11,132,3,normal
18,6,138,9,16,20,183,0,heavy
18,6,108,10,21,16,155,3,normal
18,6,82,8,19,12,121,3,normal
18,6,107,19,6,17,149,3,normal
19,6,73,1,10,32,116,1,high
19,6,54,4,13,34,105,3,normal
19,6,68,10,20,13,111,3,normal
19,6,70,9,13,25,117,3,normal
20,6,58,20,17,16,111,3,normal
20,6,99,12,13,16,140,3,normal
20,6,100,14,16,28,158,3,normal
20,6,68,14,16,20,118,3,normal
21,6,106,11,17,27,161,3,normal
21,6,83,13,9,34,139,1,high
21,6,66,14,8,24,112,3,normal
21,6,6,1,2,29,38,3,normal
22,6,11,0,0,27,38,3,normal
22,6,11,2,1,29,43,3,normal
22,6,8,2,1,28,39,3,normal
22,6,13,2,1,23,39,3,normal
23,6,7,1,1,20,29,3,normal
23,6,7,2,1,35,45,3,normal
23,6,5,2,0,25,32,3,normal
23,6,10,2,0,40,52,3,normal
0,0,14,2,0,33,49,3,normal
0,0,12,1,0,38,51,3,normal
0,0,7,1,0,27,35,3,normal
0,0,15,0,1,28,44,3,normal
1,0,12,2,1,31,46,3,normal
1,0,15,0,2,21,38,3,normal
1,0,12,1,0,36,49,3,normal
1,0,9,1,1,26,37,3,normal
2,0,7,2,1,39,49,3,normal
2,0,13,2,0,40,55,3,normal
2,0,14,1,1,27,43,3,normal
2,0,9,0,2,24,35,3,normal
3,0,13,0,0,38,51,3,normal
3,0,15,2,0,32,49,3,normal
3,0,6,0,2,24,32,3,normal
3,0,7,0,2,31,40,3,normal
4,0,84,8,2,12,106,2,low
4,0,71,0,4,23,98,3,normal
4,0,80,8,4,21,113,3,normal
4,0,77,10,7,27,121,3,normal
5,0,86,9,1,29,125,3,normal
5,0,71,0,5,18,94,2,low
5,0,78,6,2,11,97,2,low
5,0,82,22,10,9,123,3,normal
6,0,114,14,16,13,157,3,normal
6,0,115,22,23,13,173,0,heavy
6,0,81,18,12,11,122,3,normal
6,0,145,10,23,13,191,0,heavy
7,0,84,21,14,13,132,3,normal
7,0,109,27,13,14,163,3,normal
7,0,103,23,10,9,145,3,normal
7,0,131,27,20,9,187,0,heavy
8,0,113,29,12,15,169,0,heavy
8,0,127,18,20,7,172,0,heavy
8,0,125,24,17,8,174,0,heavy
8,0,88,28,25,8,149,3,normal
9,0,54,8,10,15,87,2,low
9,0,78,15,19,14,126,3,normal
9,0,39,11,16,16,82,3,normal
9,0,56,9,26,20,111,3,normal
10,0,32,10,19,18,79,3,normal
10,0,70,5,18,7,100,3,normal
10,0,55,10,30,15,110,3,normal
10,0,66,5,6,26,103,3,normal
11,0,26,6,1,30,63,3,normal
11,0,50,1,13,29,93,3,normal
11,0,52,7,1,26,86,3,normal
11,0,23,8,13,34,78,3,normal
12,0,59,9,11,28,107,3,normal
12,0,43,1,6,25,75,3,normal
12,0,21,8,4,32,65,3,normal
12,0,23,7,9,31,70,3,normal
13,0,51,3,7,17,78,2,low
13,0,84,0,30,19,133,1,high
13,0,17,19,3,10,49,2,low
13,0,79,9,19,11,118,3,normal
14,0,66,19,29,20,134,1,high
14,0,6,12,29,25,72,3,normal
14,0,61,7,25,21,114,3,normal
14,0,68,12,5,11,96,2,low
15,0,23,13,28,27,91,3,normal
15,0,22,18,15,21,76,3,normal
15,0,38,13,13,11,75,2,low
15,0,146,14,11,17,188,0,heavy
16,0,123,13,31,16,183,0,heavy
16,0,132,27,33,19,211,0,heavy
16,0,134,17,13,20,184,0,heavy
16,0,138,7,40,11,196,0,heavy
17,0,100,26,17,19,162,3,normal
17,0,117,12,36,15,180,0,heavy
17,0,142,6,28,15,191,0,heavy
17,0,149,24,36,12,221,0,heavy
18,0,110,14,35,11,170,0,heavy
18,0,105,5,20,13,143,3,normal
18,0,91,4,13,11,119,3,normal
18,0,106,4,6,15,131,3,normal
19,0,83,3,11,31,128,1,high
19,0,57,0,10,29,96,3,normal
19,0,54,15,18,22,109,3,normal
19,0,66,9,18,32,125,1,high
20,0,53,6,8,27,94,3,normal
20,0,108,18,16,30,172,0,heavy
20,0,91,15,14,28,148,3,normal
20,0,107,17,5,20,149,3,normal
21,0,83,9,19,14,125,3,normal
21,0,88,6,6,15,115,3,normal
21,0,110,1,17,23,151,3,normal
21,0,7,2,2,27,38,3,normal
22,0,10,2,1,22,35,3,normal
22,0,11,1,1,24,37,3,normal
22,0,6,1,0,25,32,3,normal
22,0,11,1,2,21,35,3,normal
23,0,12,1,0,36,49,3,normal
23,0,9,1,0,31,41,3,normal
23,0,15,0,0,38,53,3,normal
23,0,5,0,1,21,27,3,normal
0,1,10,0,2,27,39,3,normal
0,1,13,2,2,28,45,3,normal
0,1,10,0,1,21,32,3,normal
0,1,13,2,1,32,48,3,normal
1,1,13,1,2,31,47,3,normal
1,1,10,2,0,37,49,3,normal
1,1,5,2,2,34,43,3,normal
1,1,14,0,1,21,36,3,normal
2,1,10,1,2,39,52,3,normal
2,1,9,0,2,40,51,3,normal
2,1,14,0,0,31,45,3,normal
2,1,5,2,1,29,37,3,normal
3,1,10,2,0,22,34,3,normal
3,1,10,2,2,34,48,3,normal
3,1,12,2,2,29,45,3,normal
3,1,7,2,1,32,42,3,normal
4,1,70,5,5,29,109,3,normal
4,1,67,5,6,19,97,3,normal
4,1,52,6,5,14,77,2,low
4,1,59,0,4,27,90,3,normal
5,1,66,1,6,19,92,3,normal
5,1,62,6,3,18,89,2,low
5,1,72,7,5,14,98,2,low
5,1,90,10,14,9,123,3,normal
6,1,86,22,10,12,130,3,normal
6,1,125,25,22,5,177,0,heavy
6,1,81,29,24,15,149,3,normal
6,1,150,15,22,12,199,0,heavy
7,1,98,15,11,15,139,3,normal
7,1,119,24,21,9,173,0,heavy
7,1,104,23,15,6,148,3,normal
7,1,81,15,20,11,127,3,normal
8,1,90,26,25,7,148,3,normal
8,1,93,26,19,6,144,3,normal
8,1,110,25,13,9,157,3,normal
8,1,125,16,15,10,166,3,normal
9,1,47,10,9,9,75,2,low
9,1,61,14,18,14,107,3,normal
9,1,48,8,14,8,78,2,low
9,1,42,12,6,17,77,2,low
10,1,36,7,27,8,78,3,normal
10,1,30,10,28,5,73,3,normal
10,1,76,15,14,20,125,3,normal
10,1,44,7,6,30,87,3,normal
11,1,30,1,12,29,72,3,normal
11,1,56,7,7,34,104,3,normal
11,1,67,3,5,35,110,3,normal
11,1,55,8,2,30,95,3,normal
12,1,52,10,13,35,110,3,normal
12,1,28,4,0,35,67,3,normal
12,1,69,0,13,25,107,3,normal
12,1,42,9,5,25,81,3,normal
13,1,95,3,2,27,127,3,normal
13,1,45,13,33,27,118,1,high
13,1,69,5,2,15,91,2,low
13,1,85,19,2,28,134,3,normal
14,1,87,15,6,27,135,3,normal
14,1,100,13,7,17,137,3,normal
14,1,5,19,3,10,37,2,low
14,1,50,13,12,17,92,2,low
15,1,64,3,17,11,95,3,normal
15,1,97,2,5,18,122,3,normal
15,1,97,8,30,27,162,1,high
15,1,101,13,31,19,164,1,high
16,1,139,29,34,10,212,0,heavy
16,1,139,18,39,17,213,0,heavy
16,1,105,12,39,14,170,0,heavy
16,1,101,26,25,18,170,0,heavy
17,1,109,25,36,11,181,0,heavy
17,1,135,19,13,16,183,0,heavy
17,1,118,18,14,19,169,0,heavy
17,1,102,29,36,18,185,0,heavy
18,1,136,25,31,18,210,0,heavy
18,1,112,22,26,13,173,0,heavy
18,1,105,17,16,16,154,3,normal
18,1,57,12,12,35,116,1,high
19,1,52,19,14,34,119,1,high
19,1,67,6,11,17,101,2,low
19,1,64,6,12,32,114,1,high
19,1,107,6,12,32,157,1,high
20,1,87,7,5,11,110,2,low
20,1,71,8,13,28,120,3,normal
20,1,91,6,7,35,139,1,high
20,1,82,3,16,24,125,3,normal
21,1,98,16,8,31,153,1,high
21,1,84,5,6,35,130,1,high
21,1,98,18,8,18,142,3,normal
21,1,5,1,1,28,35,3,normal
22,1,6,2,0,31,39,3,normal
22,1,7,1,0,31,39,3,normal
22,1,11,1,0,30,42,3,normal
22,1,12,1,2,26,41,3,normal
23,1,11,0,0,34,45,3,normal
23,1,6,2,1,29,38,3,normal
23,1,6,0,0,36,42,3,normal
23,1,9,1,1,38,49,3,normal
0,2,13,2,0,30,45,3,normal
0,2,11,1,1,39,52,3,normal
0,2,15,0,1,34,50,3,normal
0,2,13,1,0,37,51,3,normal
1,2,13,0,0,32,45,3,normal
1,2,5,1,1,27,34,3,normal
1,2,13,1,2,27,43,3,normal
1,2,15,1,0,27,43,3,normal
2,2,10,1,0,22,33,3,normal
2,2,15,2,2,39,58,3,normal
2,2,7,2,2,30,41,3,normal
2,2,5,0,0,35,40,3,normal
3,2,15,1,1,37,54,3,normal
3,2,5,0,1,22,28,3,normal
3,2,7,2,1,23,33,3,normal
3,2,15,1,0,28,44,3,normal
4,2,88,1,3,17,109,2,low
4,2,70,8,6,13,97,2,low
4,2,71,4,5,23,103,3,normal
4,2,72,9,1,26,108,3,normal
5,2,59,2,0,12,73,2,low
5,2,52,7,0,13,72,2,low
5,2,54,7,2,30,93,3,normal
5,2,82,30,21,10,143,3,normal
6,2,124,27,25,15,191,0,heavy
6,2,143,22,21,5,191,0,heavy
6,2,107,21,15,11,154,3,normal
6,2,95,30,24,6,155,3,normal
7,2,106,29,23,11,169,0,heavy
7,2,145,22,24,14,205,0,heavy
7,2,111,17,15,12,155,3,normal
7,2,142,13,14,6,175,0,heavy
8,2,112,22,17,15,166,3,normal
8,2,134,27,19,8,188,0,heavy
8,2,86,15,23,6,130,3,normal
8,2,103,19,15,9,146,3,normal
9,2,55,11,25,14,105,3,normal
9,2,62,8,21,10,101,3,normal
9,2,41,8,5,17,71,2,low
9,2,58,10,14,7,89,2,low
10,2,78,14,13,7,112,3,normal
10,2,49,12,13,12,86,2,low
10,2,63,10,10,20,103,3,normal
10,2,45,0,12,30,87,3,normal
11,2,69,7,6,27,109,3,normal
11,2,50,6,10,35,101,3,normal
11,2,66,6,12,25,109,3,normal
11,2,47,10,2,34,93,3,normal
12,2,61,2,9,27,99,3,normal
12,2,57,10,0,27,94,3,normal
12,2,26,3,3,29,61,3,normal
12,2,30,4,2,32,68,3,normal
13,2,9,13,2,19,43,3,normal
13,2,46,10,34,21,111,3,normal
13,2,11,16,28,23,78,3,normal
13,2,96,1,5,25,127,3,normal
14,2,29,12,18,18,77,3,normal
14,2,50,8,34,26,118,1,high
14,2,85,7,5,20,117,3,normal
14,2,77,12,22,23,134,3,normal
15,2,16,4,2,14,36,2,low
15,2,38,17,5,14,74,2,low
15,2,11,10,23,17,61,3,normal
15,2,119,18,17,14,168,0,heavy
16,2,111,8,37,10,166,1,high
16,2,118,10,13,16,157,3,normal
16,2,119,13,28,13,173,0,heavy
16,2,144,18,28,13,203,0,heavy
17,2,133,29,14,11,187,0,heavy
17,2,134,5,21,15,175,0,heavy
17,2,140,20,27,13,200,0,heavy
17,2,116,27,34,20,197,0,heavy
18,2,121,15,19,20,175,0,heavy
18,2,123,30,32,12,197,0,heavy
18,2,62,0,19,34,115,1,high
18,2,91,17,14,15,137,3,normal
19,2,107,20,20,19,166,3,normal
19,2,75,14,5,35,129,1,high
19,2,96,3,10,33,142,1,high
19,2,66,2,11,24,103,3,normal
20,2,89,15,13,31,148,1,high
20,2,69,13,7,22,111,3,normal
20,2,109,16,19,13,157,3,normal
20,2,54,0,20,11,85,3,normal
21,2,79,0,8,25,112,3,normal
21,2,78,17,20,11,126,3,normal
21,2,93,0,10,18,121,3,normal
21,2,9,1,1,36,47,3,normal
22,2,13,0,0,29,42,3,normal
22,2,13,2,1,28,44,3,normal
22,2,14,0,0,40,54,3,normal
22,2,11,1,1,35,48,3,normal
23,2,11,2,1,38,52,3,normal
23,2,15,1,2,35,53,3,normal
23,2,7,1,0,38,46,3,normal
23,2,10,0,0,32,42,3,normal
0,3,6,2,1,35,44,3,normal
0,3,13,2,1,33,49,3,normal
0,3,8,0,0,39,47,3,normal
0,3,9,0,0,35,44,3,normal
1,3,6,2,2,35,45,3,normal
1,3,13,2,1,25,41,3,normal
1,3,12,0,0,33,45,3,normal
1,3,12,1,1,33,47,3,normal
2,3,11,2,0,20,33,3,normal
2,3,11,2,2,27,42,3,normal
2,3,9,1,0,26,36,3,normal
2,3,12,2,0,33,47,3,normal
3,3,11,0,1,40,52,3,normal
3,3,8,2,2,23,35,3,normal
3,3,6,2,1,32,41,3,normal
3,3,8,1,2,31,42,3,normal
4,3,50,9,4,12,75,2,low
4,3,90,0,4,21,115,3,normal
4,3,51,7,5,11,74,2,low
4,3,83,0,4,13,100,2,low
5,3,86,5,0,21,112,3,normal
5,3,76,0,3,22,101,3,normal
5,3,72,4,5,16,97,2,low
5,3,101,20,18,13,152,3,normal
6,3,139,13,21,8,181,0,heavy
6,3,113,27,12,8,160,3,normal
6,3,125,26,12,15,178,0,heavy
6,3,130,18,17,13,178,0,heavy
7,3,129,17,21,5,172,0,heavy
7,3,104,28,10,8,150,3,normal
7,3,85,27,21,13,146,3,normal
7,3,95,12,25,15,147,3,normal
8,3,105,20,11,8,144,3,normal
8,3,129,27,21,9,186,0,heavy
8,3,122,26,21,10,179,0,heavy
8,3,80,14,22,6,122,3,normal
9,3,67,8,25,20,120,3,normal
9,3,74,7,17,10,108,3,normal
9,3,30,8,25,10,73,3,normal
9,3,58,8,23,19,108,3,normal
10,3,57,13,10,9,89,2,low
10,3,55,12,30,5,102,3,normal
10,3,44,5,11,18,78,2,low
10,3,59,5,10,31,105,3,normal
11,3,57,1,12,28,98,3,normal
11,3,67,6,6,29,108,3,normal
11,3,46,6,11,35,98,3,normal
11,3,39,5,10,27,81,3,normal
12,3,39,8,5,32,84,3,normal
12,3,20,4,9,31,64,3,normal
12,3,70,1,8,25,104,3,normal
12,3,31,8,13,25,77,3,normal
13,3,10,4,3,18,35,2,low
13,3,55,7,24,15,101,3,normal
13,3,72,12,18,23,125,3,normal
13,3,38,7,27,13,85,3,normal
14,3,79,12,22,14,127,3,normal
14,3,40,9,6,10,65,2,low
14,3,28,2,1,11,42,2,low
14,3,99,6,10,23,138,3,normal
15,3,44,19,28,26,117,1,high
15,3,91,0,11,25,127,3,normal
15,3,28,15,17,20,80,3,normal
15,3,111,27,20,20,178,0,heavy
16,3,113,10,33,10,166,1,high
16,3,119,27,17,17,180,0,heavy
16,3,146,28,12,11,197,0,heavy
16,3,127,30,20,13,190,0,heavy
17,3,138,10,10,20,178,0,heavy
17,3,107,27,19,18,171,0,heavy
17,3,102,14,16,20,152,3,normal
17,3,125,29,12,14,180,0,heavy
18,3,112,12,30,10,164,1,high
18,3,123,19,14,19,175,0,heavy
18,3,106,19,7,15,147,3,normal
18,3,76,16,13,20,125,3,normal
19,3,65,5,6,19,95,3,normal
19,3,59,18,8,24,109,3,normal
19,3,99,0,5,30,134,3,normal
19,3,74,1,8,25,108,3,normal
20,3,105,16,15,33,169,0,heavy
20,3,57,8,11,16,92,2,low
20,3,100,16,13,20,149,3,normal
20,3,91,16,16,22,145,3,normal
21,3,71,4,15,34,124,1,high
21,3,70,12,19,15,116,3,normal
21,3,68,0,7,14,89,2,low
21,3,12,1,1,30,44,3,normal
22,3,14,1,1,35,51,3,normal
22,3,8,0,1,25,34,3,normal
22,3,7,2,2,20,31,3,normal
22,3,8,0,1,30,39,3,normal
23,3,13,0,1,30,44,3,normal
23,3,15,1,2,30,48,3,normal
23,3,9,1,1,32,43,3,normal
23,3,5,1,0,36,42,3,normal
0,4,13,1,0,37,51,3,normal
0,4,14,0,2,30,46,3,normal
0,4,13,1,2,26,42,3,normal
0,4,8,0,1,32,41,3,normal
1,4,10,0,1,37,48,3,normal
1,4,15,1,0,27,43,3,normal
1,4,7,2,2,40,51,3,normal
1,4,12,0,0,32,44,3,normal
2,4,14,1,1,21,37,3,normal
2,4,5,1,2,30,38,3,normal
2,4,8,1,0,24,33,3,normal
2,4,15,0,0,27,42,3,normal
3,4,14,1,1,26,42,3,normal
3,4,12,1,2,36,51,3,normal
3,4,13,1,1,25,40,3,normal
3,4,14,2,0,38,54,3,normal
4,4,43,8,0,28,79,3,normal
4,4,26,1,2,34,63,3,normal
4,4,49,1,5,32,87,3,normal
4,4,65,9,2,53,129,1,high
5,4,46,4,2,59,111,3,normal
5,4,79,4,3,26,112,3,normal
5,4,32,9,4,58,103,3,normal
5,4,57,3,3,38,101,3,normal
6,4,73,4,0,39,116,1,high
6,4,29,1,0,39,69,3,normal
6,4,79,10,1,28,118,3,normal
6,4,59,8,5,44,116,1,high
7,4,71,1,4,44,120,1,high
7,4,50,10,2,56,118,1,high
7,4,62,7,2,35,106,3,normal
7,4,72,0,4,27,103,3,normal
8,4,54,10,5,34,103,3,normal
8,4,31,3,3,26,63,3,normal
8,4,72,6,4,36,118,1,high
8,4,68,6,1,28,103,3,normal
9,4,116,34,5,7,162,3,normal
9,4,149,37,14,10,210,0,heavy
9,4,143,48,19,5,215,0,heavy
9,4,143,21,6,6,176,0,heavy
10,4,100,26,14,6,146,3,normal
10,4,139,30,13,10,192,0,heavy
10,4,103,23,6,7,139,3,normal
10,4,136,38,13,6,193,0,heavy
11,4,101,42,13,6,162,3,normal
11,4,144,43,13,8,208,0,heavy
11,4,101,34,12,7,154,3,normal
11,4,109,31,8,8,156,3,normal
12,4,125,22,18,8,173,0,heavy
12,4,108,28,16,9,161,3,normal
12,4,147,35,19,8,209,0,heavy
12,4,128,49,7,9,193,0,heavy
13,4,130,43,15,6,194,0,heavy
13,4,102,23,8,6,139,3,normal
13,4,113,38,17,10,178,0,heavy
13,4,147,38,5,8,198,0,heavy
14,4,109,30,7,9,155,3,normal
14,4,123,29,16,10,178,0,heavy
14,4,121,41,14,5,181,0,heavy
14,4,136,46,9,10,201,0,heavy
15,4,58,14,14,15,101,2,low
15,4,62,6,7,12,87,2,low
15,4,62,7,9,7,85,2,low
15,4,55,6,2,18,81,2,low
16,4,87,15,15,16,133,3,normal
16,4,62,5,14,9,90,2,low
16,4,82,5,5,5,97,2,low
16,4,68,5,0,16,89,2,low
17,4,66,11,9,5,91,2,low
17,4,76,14,15,11,116,3,normal
17,4,89,8,4,15,116,3,normal
17,4,81,13,0,14,108,2,low
18,4,56,5,9,17,87,2,low
18,4,52,6,5,6,69,2,low
18,4,80,6,14,13,113,3,normal
18,4,81,15,11,20,127,3,normal
19,4,37,2,4,31,74,3,normal
19,4,24,1,3,35,63,3,normal
19,4,26,2,4,35,67,3,normal
19,4,28,2,2,41,73,3,normal
20,4,49,1,5,34,89,3,normal
20,4,38,1,2,40,81,3,normal
20,4,20,3,4,40,67,3,normal
20,4,28,0,3,42,73,3,normal
21,4,27,5,1,25,58,3,normal
21,4,28,2,4,44,78,3,normal
21,4,21,4,5,31,61,3,normal
21,4,5,1,2,33,41,3,normal
22,4,7,1,0,22,30,3,normal
22,4,13,0,2,29,44,3,normal
22,4,15,0,1,28,44,3,normal
22,4,15,0,1,38,54,3,normal
23,4,15,0,0,34,49,3,normal
23,4,13,0,1,34,48,3,normal
23,4,11,2,1,29,43,3,normal
23,4,13,1,2,26,42,3,normal
0,5,15,0,1,21,37,3,normal
0,5,6,0,2,21,29,3,normal
0,5,12,0,2,37,51,3,normal
0,5,6,0,2,23,31,3,normal
1,5,12,2,0,34,48,3,normal
1,5,8,0,1,35,44,3,normal
1,5,6,2,0,24,32,3,normal
1,5,14,1,1,35,51,3,normal
2,5,14,0,1,27,42,3,normal
2,5,14,1,1,37,53,3,normal
2,5,11,2,2,33,48,3,normal
2,5,8,0,1,20,29,3,normal
3,5,9,1,2,27,39,3,normal
3,5,8,1,1,27,37,3,normal
3,5,6,2,1,30,39,3,normal
3,5,7,2,2,27,38,3,normal
4,5,50,5,4,16,75,2,low
4,5,59,8,7,17,91,2,low
4,5,70,8,0,24,102,3,normal
4,5,61,6,5,12,84,2,low
5,5,67,4,3,16,90,2,low
5,5,63,7,0,23,93,3,normal
5,5,53,1,1,23,78,3,normal
5,5,106,22,17,8,153,3,normal
6,5,114,18,24,6,162,3,normal
6,5,103,14,14,10,141,3,normal
6,5,118,27,10,12,167,2,low
6,5,120,11,12,9,152,3,normal
7,5,144,22,12,10,188,0,heavy
7,5,123,20,21,6,170,0,heavy
7,5,91,26,11,15,143,3,normal
7,5,143,26,22,10,201,0,heavy
8,5,120,13,11,5,149,3,normal
8,5,80,13,11,5,109,2,low
8,5,123,30,13,12,178,0,heavy
8,5,143,25,14,12,194,0,heavy
9,5,39,5,17,14,75,3,normal
9,5,73,12,25,16,126,3,normal
9,5,75,14,24,18,131,3,normal
9,5,38,15,6,6,65,2,low
10,5,66,6,7,16,95,2,low
10,5,45,14,18,14,91,3,normal
10,5,77,11,13,6,107,2,low
10,5,58,7,2,25,92,3,normal
11,5,61,8,7,34,110,3,normal
11,5,46,2,0,25,73,3,normal
11,5,55,3,4,25,87,3,normal
11,5,36,8,3,29,76,3,normal
12,5,52,1,8,29,90,3,normal
12,5,32,5,4,26,67,3,normal
12,5,38,5,7,27,77,3,normal
12,5,24,2,12,32,70,3,normal
13,5,90,15,24,29,158,3,normal
13,5,17,4,4,11,36,2,low
13,5,85,5,1,26,117,3,normal
13,5,34,17,19,20,90,3,normal
14,5,55,16,17,16,104,3,normal
14,5,25,3,28,17,73,3,normal
14,5,64,13,9,12,98,2,low
14,5,59,14,24,21,118,3,normal
15,5,11,3,2,14,30,2,low
15,5,88,3,31,23,145,1,high
15,5,100,19,23,22,164,3,normal
15,5,144,16,25,18,203,0,heavy
16,5,116,23,37,11,187,0,heavy
16,5,114,6,38,11,169,0,heavy
16,5,130,10,19,10,169,0,heavy
16,5,144,19,18,15,196,0,heavy
17,5,119,13,38,18,188,0,heavy
17,5,131,6,17,12,166,3,normal
17,5,123,18,18,12,171,0,heavy
17,5,147,14,32,10,203,0,heavy
18,5,114,27,32,10,183,0,heavy
18,5,113,27,35,10,185,0,heavy
18,5,98,8,9,14,129,3,normal
18,5,76,3,8,13,100,2,low
19,5,108,8,6,21,143,3,normal
19,5,63,11,5,26,105,3,normal
19,5,72,20,5,18,115,3,normal
19,5,80,0,12,13,105,2,low
20,5,59,7,14,16,96,2,low
20,5,99,12,14,34,159,1,high
20,5,65,16,9,14,104,2,low
20,5,81,18,16,33,148,1,high
21,5,103,14,11,11,139,3,normal
21,5,81,18,5,17,121,3,normal
21,5,52,9,5,34,100,3,normal
21,5,6,0,2,40,48,3,normal
22,5,6,2,0,40,48,3,normal
22,5,9,1,0,22,32,3,normal
22,5,11,1,0,26,38,3,normal
22,5,14,2,1,39,56,3,normal
23,5,7,1,1,30,39,3,normal
23,5,8,2,2,35,47,3,normal
23,5,5,2,2,33,42,3,normal
23,5,6,1,2,23,32,3,normal
0,6,15,0,2,32,49,3,normal
0,6,15,0,2,29,46,3,normal
0,6,7,2,2,33,44,3,normal
0,6,14,2,0,33,49,3,normal
1,6,6,1,1,38,46,3,normal
1,6,11,0,0,26,37,3,normal
1,6,6,2,1,34,43,3,normal
1,6,7,0,2,22,31,3,normal
2,6,13,2,0,24,39,3,normal
2,6,5,2,1,33,41,3,normal
2,6,10,0,1,40,51,3,normal
2,6,12,1,2,26,41,3,normal
3,6,8,0,0,28,36,3,normal
3,6,7,0,2,36,45,3,normal
3,6,14,0,0,32,46,3,normal
3,6,14,2,2,39,57,3,normal
4,6,57,6,1,30,94,3,normal
4,6,64,4,7,15,90,2,low
4,6,80,9,7,29,125,3,normal
4,6,80,2,2,18,102,2,low
5,6,78,4,0,11,93,2,low
5,6,51,8,0,29,88,3,normal
5,6,66,3,0,27,96,3,normal
5,6,146,19,25,8,198,0,heavy
6,6,104,22,15,8,149,3,normal
6,6,137,22,14,10,183,0,heavy
6,6,150,26,18,10,204,0,heavy
6,6,148,15,22,8,193,0,heavy
7,6,83,30,12,10,135,3,normal
7,6,96,22,23,8,149,3,normal
7,6,112,10,23,11,156,3,normal
7,6,145,20,24,13,202,0,heavy
8,6,86,28,19,9,142,3,normal
8,6,127,27,17,15,186,0,heavy
8,6,88,12,19,10,129,3,normal
8,6,103,11,19,5,138,3,normal
9,6,74,14,28,15,131,1,high
9,6,42,10,20,5,77,3,normal
9,6,55,11,20,19,105,3,normal
9,6,71,8,28,11,118,1,high
10,6,55,5,23,16,99,3,normal
10,6,43,8,22,20,93,3,normal
10,6,54,11,11,11,87,2,low
10,6,58,9,3,32,102,3,normal
11,6,46,1,11,35,93,3,normal
11,6,64,6,7,30,107,3,normal
11,6,43,5,3,31,82,3,normal
11,6,39,10,2,33,84,3,normal
12,6,59,2,9,33,103,3,normal
12,6,56,5,6,33,100,3,normal
12,6,40,5,12,26,83,3,normal
12,6,69,4,7,26,106,3,normal
13,6,53,2,14,12,81,2,low
13,6,22,7,8,27,64,3,normal
13,6,33,16,5,30,84,3,normal
13,6,35,14,16,20,85,3,normal
14,6,12,3,11,15,41,2,low
14,6,83,12,8,23,126,3,normal
14,6,39,7,11,19,76,3,normal
14,6,44,12,25,12,93,3,normal
15,6,57,19,11,16,103,2,low
15,6,13,19,7,12,51,2,low
15,6,79,17,12,13,121,3,normal
15,6,127,20,16,17,180,0,heavy
16,6,112,19,15,18,164,3,normal
16,6,122,12,20,19,173,0,heavy
16,6,141,22,29,12,204,0,heavy
16,6,131,29,33,12,205,0,heavy
17,6,126,6,22,15,169,0,heavy
17,6,128,14,11,18,171,0,heavy
17,6,137,29,36,18,220,0,heavy
17,6,129,18,10,18,175,0,heavy
18,6,100,30,31,20,181,0,heavy
18,6,136,16,17,11,180,0,heavy
18,6,94,8,14,19,135,3,normal
18,6,86,14,13,33,146,1,high
19,6,81,0,7,15,103,2,low
19,6,84,1,16,19,120,3,normal
19,6,76,11,16,17,120,3,normal
19,6,76,11,19,17,123,3,normal
20,6,83,10,19,18,130,3,normal
20,6,60,2,10,18,90,2,low
20,6,55,9,15,25,104,3,normal
20,6,69,3,19,32,123,1,high
21,6,52,2,9,19,82,3,normal
21,6,74,9,15,33,131,1,high
21,6,102,18,20,31,171,0,heavy
21,6,9,2,2,31,44,3,normal
22,6,14,1,1,28,44,3,normal
22,6,8,2,2,35,47,3,normal
22,6,14,0,0,28,42,3,normal
22,6,6,2,2,40,50,3,normal
23,6,12,2,1,34,49,3,normal
23,6,15,0,1,25,41,3,normal
23,6,13,1,2,40,56,3,normal
23,6,9,2,2,32,45,3,normal
0,0,9,2,0,27,38,3,normal
0,0,14,1,0,30,45,3,normal
0,0,15,2,0,30,47,3,normal
0,0,7,2,0,26,35,3,normal
1,0,5,0,2,23,30,3,normal
1,0,9,1,0,27,37,3,normal
1,0,6,2,2,28,38,3,normal
1,0,7,2,1,39,49,3,normal
2,0,6,2,1,27,36,3,normal
2,0,6,1,1,36,44,3,normal
2,0,10,1,2,25,38,3,normal
2,0,12,2,0,40,54,3,normal
3,0,10,0,1,34,45,3,normal
3,0,8,0,1,22,31,3,normal
3,0,10,0,2,37,49,3,normal
3,0,12,1,2,21,36,3,normal
4,0,73,7,2,22,104,3,normal
4,0,59,9,4,20,92,3,normal
4,0,52,2,5,30,89,3,normal
4,0,63,6,3,28,100,3,normal
5,0,77,2,5,19,103,3,normal
5,0,58,8,7,13,86,2,low
5,0,72,1,5,11,89,2,low
5,0,126,14,14,8,162,3,normal
6,0,91,29,19,15,154,3,normal
6,0,134,18,14,6,172,0,heavy
6,0,96,18,16,7,137,3,normal
6,0,112,22,12,5,151,3,normal
7,0,125,22,10,9,166,3,normal
7,0,142,25,22,5,194,0,heavy
7,0,102,19,13,10,144,3,normal
7,0,89,23,19,12,143,3,normal
8,0,119,15,17,12,163,3,normal
8,0,137,13,19,14,183,0,heavy
8,0,128,21,19,13,181,0,heavy
8,0,81,20,18,15,134,3,normal
9,0,49,15,15,5,84,2,low
9,0,59,6,10,17,92,2,low
9,0,69,5,26,6,106,3,normal
9,0,72,10,7,20,109,3,normal
10,0,44,15,16,16,91,3,normal
10,0,68,15,26,11,120,1,high
10,0,74,9,14,6,103,2,low
10,0,35,6,10,35,86,3,normal
11,0,62,9,12,32,115,1,high
11,0,46,10,0,34,90,3,normal
11,0,63,5,2,31,101,3,normal
11,0,58,10,2,27,97,3,normal
12,0,68,0,12,35,115,1,high
12,0,27,7,0,33,67,3,normal
12,0,24,4,11,33,72,3,normal
12,0,70,6,8,35,119,1,high
13,0,14,19,22,15,70,3,normal
13,0,72,8,17,28,125,3,normal
13,0,14,0,26,20,60,3,normal
13,0,97,4,25,18,144,3,normal
14,0,23,19,3,19,64,3,normal
14,0,46,3,32,27,108,3,normal
14,0,23,17,27,13,80,3,normal
14,0,48,4,8,17,77,2,low
15,0,89,13,7,27,136,3,normal
15,0,48,10,23,26,107,3,normal
15,0,77,13,19,11,120,3,normal
15,0,118,8,27,16,169,0,heavy
16,0,145,19,22,19,205,0,heavy
16,0,103,23,18,19,163,3,normal
16,0,126,22,28,16,192,0,heavy
16,0,120,24,30,10,184,0,heavy
17,0,128,10,14,18,170,0,heavy
17,0,142,26,32,10,210,0,heavy
17,0,121,25,33,13,192,0,heavy
17,0,144,6,18,12,180,0,heavy
18,0,116,26,14,18,174,0,heavy
18,0,138,21,39,17,215,0,heavy
18,0,103,5,7,13,128,3,normal
18,0,100,14,10,22,146,3,normal
19,0,93,11,20,11,135,3,normal
19,0,97,17,19,33,166,1,high
19,0,81,9,15,25,130,3,normal
19,0,101,8,7,10,126,3,normal
20,0,106,7,7,26,146,3,normal
20,0,86,8,18,13,125,3,normal
20,0,74,14,12,20,120,3,normal
20,0,64,13,13,16,106,2,low
21,0,60,20,12,32,124,1,high
21,0,58,15,12,31,116,1,high
21,0,95,7,18,34,154,1,high
21,0,5,2,2,29,38,3,normal
22,0,13,2,0,38,53,3,normal
22,0,8,1,1,33,43,3,normal
22,0,5,2,0,31,38,3,normal
22,0,5,1,1,25,32,3,normal
23,0,15,2,2,32,51,3,normal
23,0,13,1,2,38,54,3,normal
23,0,6,2,1,22,31,3,normal
23,0,8,1,2,27,38,3,normal
0,1,9,0,0,39,48,3,normal
0,1,15,1,1,31,48,3,normal
0,1,8,0,2,25,35,3,normal
0,1,15,1,0,29,45,3,normal
1,1,6,1,1,34,42,3,normal
1,1,10,2,1,33,46,3,normal
1,1,9,0,1,23,33,3,normal
1,1,10,1,0,28,39,3,normal
2,1,10,2,1,38,51,3,normal
2,1,9,0,1,38,48,3,normal
2,1,6,2,2,20,30,3,normal
2,1,15,0,0,32,47,3,normal
3,1,9,0,0,22,31,3,normal
3,1,11,1,0,26,38,3,normal
3,1,9,0,0,25,34,3,normal
3,1,14,1,2,20,37,3,normal
4,1,64,0,2,12,78,2,low
4,1,60,8,7,11,86,2,low
4,1,77,5,0,20,102,3,normal
4,1,59,1,7,11,78,2,low
5,1,72,2,6,11,91,2,low
5,1,86,10,2,12,110,2,low
5,1,79,7,4,10,100,2,low
5,1,128,29,24,9,190,0,heavy
6,1,140,15,13,7,175,0,heavy
6,1,150,28,12,9,199,0,heavy
6,1,81,19,22,5,127,3,normal
6,1,88,12,12,6,118,3,normal
7,1,97,10,16,10,133,3,normal
7,1,92,11,23,11,137,3,normal
7,1,109,23,18,13,163,3,normal
7,1,104,29,21,15,169,0,heavy
8,1,130,17,17,12,176,0,heavy
8,1,90,18,25,6,139,3,normal
8,1,113,12,12,9,146,3,normal
8,1,98,29,24,5,156,3,normal
9,1,35,10,11,17,73,2,low
9,1,31,13,11,7,62,2,low
9,1,80,9,9,9,107,2,low
9,1,60,10,8,11,89,2,low
10,1,67,7,19,12,105,3,normal
10,1,38,15,9,19,81,3,normal
10,1,62,11,9,12,94,2,low
10,1,21,10,0,25,56,3,normal
11,1,41,0,9,25,75,3,normal
11,1,57,1,6,29,93,3,normal
11,1,26,0,11,33,70,3,normal
11,1,50,9,10,29,98,3,normal
12,1,56,3,11,28,98,3,normal
12,1,59,4,8,30,101,3,normal
12,1,61,9,10,26,106,3,normal
12,1,56,7,8,31,102,3,normal
13,1,23,2,5,22,52,3,normal
13,1,73,8,10,23,114,3,normal
13,1,98,8,26,18,150,1,high
13,1,22,6,23,10,61,3,normal
14,1,38,7,27,22,94,3,normal
14,1,76,12,8,15,111,2,low
14,1,79,15,26,30,150,1,high
14,1,76,6,6,29,117,3,normal
15,1,62,6,29,23,120,1,high
15,1,19,2,23,25,69,3,normal
15,1,13,10,35,19,77,3,normal
15,1,105,6,16,18,145,3,normal
16,1,144,14,12,16,186,0,heavy
16,1,121,17,35,14,187,0,heavy
16,1,145,5,20,12,182,0,heavy
16,1,127,11,24,16,178,0,heavy
17,1,116,11,11,16,154,3,normal
17,1,128,9,29,20,186,0,heavy
17,1,116,18,32,18,184,0,heavy
17,1,149,20,17,13,199,0,heavy
18,1,144,27,22,16,209,0,heavy
18,1,145,6,40,13,204,0,heavy
18,1,63,2,11,32,108,3,normal
18,1,110,16,18,34,178,0,heavy
19,1,63,11,10,23,107,3,normal
19,1,106,8,10,31,155,1,high
19,1,50,9,11,22,92,3,normal
19,1,53,13,12,15,93,2,low
20,1,81,0,18,12,111,3,normal
20,1,90,20,20,10,140,3,normal
20,1,56,12,9,22,99,3,normal
20,1,90,0,11,32,133,1,high
21,1,102,4,8,28,142,3,normal
21,1,99,0,11,21,131,3,normal
21,1,85,2,16,25,128,3,normal
21,1,13,2,2,26,43,3,normal
22,1,12,1,1,20,34,3,normal
22,1,7,0,1,35,43,3,normal
22,1,9,0,2,38,49,3,normal
22,1,8,1,0,26,35,3,normal
23,1,5,0,0,35,40,3,normal
23,1,13,1,2,30,46,3,normal
23,1,7,2,2,37,48,3,normal
23,1,9,2,2,28,41,3,normal
0,2,6,1,1,35,43,3,normal
0,2,14,0,1,20,35,3,normal
0,2,11,0,2,39,52,3,normal
0,2,9,2,0,28,39,3,normal
1,2,5,0,0,22,27,3,normal
1,2,9,0,0,24,33,3,normal
1,2,5,2,2,30,39,3,normal
1,2,9,0,1,27,37,3,normal
2,2,9,1,0,39,49,3,normal
2,2,6,0,0,33,39,3,normal
2,2,13,2,1,30,46,3,normal
2,2,5,0,1,34,40,3,normal
3,2,5,0,0,34,39,3,normal
3,2,9,2,2,29,42,3,normal
3,2,9,1,0,34,44,3,normal
3,2,8,0,0,40,48,3,normal
4,2,64,10,7,15,96,2,low
4,2,66,3,1,26,96,3,normal
4,2,57,10,2,18,87,2,low
4,2,76,7,4,15,102,2,low
5,2,71,8,5,21,105,3,normal
5,2,65,0,6,30,101,3,normal
5,2,54,2,3,13,72,2,low
5,2,107,10,23,5,145,3,normal
6,2,102,28,22,11,163,3,normal
6,2,118,16,19,8,161,3,normal
6,2,144,13,10,5,172,0,heavy
6,2,147,21,12,11,191,0,heavy
7,2,116,10,11,13,150,3,normal
7,2,142,11,25,5,183,0,heavy
7,2,105,25,13,9,152,3,normal
7,2,138,23,17,12,190,0,heavy
8,2,144,15,15,14,188,0,heavy
8,2,122,24,17,9,172,0,heavy
8,2,137,28,17,14,196,0,heavy
8,2,113,16,12,12,153,3,normal
9,2,78,8,11,9,106,2,low
9,2,44,12,27,13,96,3,normal
9,2,57,13,11,14,95,2,low
9,2,72,9,27,12,120,1,high
10,2,58,14,7,16,95,2,low
10,2,80,9,26,10,125,1,high
10,2,68,12,10,18,108,2,low
10,2,57,8,13,32,110,3,normal
11,2,37,10,5,33,85,3,normal
11,2,59,0,1,26,86,3,normal
11,2,31,9,13,33,86,3,normal
11,2,54,8,9,30,101,3,normal
12,2,33,6,0,29,68,3,normal
12,2,65,0,13,28,106,3,normal
12,2,24,4,6,29,63,3,normal
12,2,46,10,12,29,97,3,normal
13,2,37,16,3,23,79,3,normal
13,2,42,16,26,17,101,3,normal
13,2,74,8,7,29,118,3,normal
13,2,43,12,21,11,87,3,normal
14,2,72,5,11,29,117,3,normal
14,2,62,14,22,19,117,3,normal
14,2,55,13,16,10,94,3,normal
14,2,97,9,15,26,147,3,normal
15,2,42,17,2,11,72,2,low
15,2,16,14,14,18,62,2,low
15,2,73,0,33,30,136,1,high
15,2,106,5,29,14,154,1,high
16,2,142,16,18,10,186,0,heavy
16,2,112,8,21,17,158,3,normal
16,2,129,7,26,15,177,0,heavy
16,2,131,11,10,18,170,0,heavy
17,2,104,17,12,16,149,3,normal
17,2,128,19,32,20,199,0,heavy
17,2,144,16,14,11,185,0,heavy
17,2,150,5,11,18,184,0,heavy
18,2,128,20,16,16,180,0,heavy
18,2,104,28,12,11,155,3,normal
18,2,62,13,6,15,96,2,low
18,2,66,16,17,35,134,1,high
19,2,103,10,8,27,148,3,normal
19,2,63,0,10,18,91,2,low
19,2,100,11,10,35,156,1,high
19,2,70,1,7,20,98,3,normal
20,2,82,13,6,18,119,3,normal
20,2,98,16,17,33,164,1,high
20,2,60,4,20,31,115,1,high
20,2,90,18,15,23,146,3,normal
21,2,64,9,8,25,106,3,normal
21,2,82,14,11,18,125,3,normal
21,2,55,9,15,17,96,2,low
21,2,7,1,2,24,34,3,normal
22,2,11,0,1,28,40,3,normal
22,2,9,1,1,20,31,3,normal
22,2,15,0,2,40,57,3,normal
22,2,12,1,1,24,38,3,normal
23,2,8,0,1,32,41,3,normal
23,2,7,2,0,36,45,3,normal
23,2,8,1,2,36,47,3,normal
23,2,6,2,0,23,31,3,normal
0,3,12,1,2,33,48,3,normal
0,3,9,0,1,25,35,3,normal
0,3,13,0,2,23,38,3,normal
0,3,15,2,0,28,45,3,normal
1,3,9,1,1,31,42,3,normal
1,3,10,1,1,32,44,3,normal
1,3,10,0,0,33,43,3,normal
1,3,12,1,0,35,48,3,normal
2,3,15,0,2,27,44,3,normal
2,3,13,1,2,34,50,3,normal
2,3,12,0,1,35,48,3,normal
2,3,13,2,0,28,43,3,normal
3,3,6,1,1,21,29,3,normal
3,3,12,1,0,27,40,3,normal
3,3,8,0,0,20,28,3,normal
3,3,8,2,2,35,47,3,normal
4,3,65,1,6,18,90,2,low
4,3,60,8,6,10,84,2,low
4,3,56,10,4,11,81,2,low
4,3,57,0,3,21,81,3,normal
5,3,78,5,6,12,101,2,low
5,3,67,10,1,25,103,3,normal
5,3,83,3,7,20,113,3,normal
5,3,102,25,15,8,150,3,normal
6,3,96,22,10,8,136,3,normal
6,3,101,21,19,15,156,3,normal
6,3,88,21,24,13,146,3,normal
6,3,118,11,16,5,150,3,normal
7,3,106,14,15,11,146,3,normal
7,3,150,30,14,15,209,0,heavy
7,3,80,18,23,7,128,3,normal
7,3,142,29,15,5,191,0,heavy
8,3,81,30,22,6,139,3,normal
8,3,109,18,14,8,149,3,normal
8,3,130,14,13,6,163,3,normal
8,3,150,19,23,12,204,0,heavy
9,3,63,5,14,10,92,2,low
9,3,36,6,15,6,63,2,low
9,3,60,6,6,11,83,2,low
9,3,46,11,9,17,83,2,low
10,3,78,15,26,15,134,1,high
10,3,54,5,11,7,77,2,low
10,3,39,10,28,11,88,3,normal
10,3,62,1,11,34,108,3,normal
11,3,59,2,11,33,105,3,normal
11,3,61,4,8,34,107,3,normal
11,3,62,10,12,35,119,1,high
11,3,42,8,6,35,91,3,normal
12,3,64,5,1,34,104,3,normal
12,3,57,5,2,29,93,3,normal
12,3,68,4,9,26,107,3,normal
12,3,24,7,2,29,62,3,normal
13,3,12,1,33,24,70,3,normal
13,3,85,2,30,16,133,1,high
13,3,41,18,30,14,103,3,normal
13,3,6,16,26,18,66,3,normal
14,3,75,1,18,20,114,3,normal
14,3,92,15,17,15,139,3,normal
14,3,71,2,5,20,98,3,normal
14,3,98,20,21,14,153,3,normal
15,3,77,6,16,28,127,3,normal
15,3,61,0,24,19,104,3,normal
15,3,90,5,13,16,124,3,normal
15,3,119,8,34,12,173,0,heavy
16,3,120,17,37,14,188,0,heavy
16,3,141,23,24,15,203,0,heavy
16,3,118,30,28,11,187,0,heavy
16,3,139,30,33,16,218,0,heavy
17,3,132,16,13,11,172,0,heavy
17,3,115,26,34,20,195,0,heavy
17,3,105,16,32,17,170,0,heavy
17,3,116,10,27,11,164,1,high
18,3,147,22,17,20,206,0,heavy
18,3,138,13,15,13,179,0,heavy
18,3,84,4,14,33,135,1,high
18,3,86,11,12,14,123,3,normal
19,3,75,2,17,31,125,1,high
19,3,51,5,5,17,78,2,low
19,3,76,18,5,21,120,3,normal
19,3,67,12,10,16,105,2,low
20,3,99,4,9,19,131,3,normal
20,3,66,19,16,30,131,3,normal
20,3,69,0,8,13,90,2,low
20,3,50,18,5,34,107,3,normal
21,3,56,19,11,24,110,3,normal
21,3,107,17,11,28,163,3,normal
21,3,110,16,7,34,167,3,normal
21,3,5,0,1,24,30,3,normal
22,3,6,0,1,36,43,3,normal
22,3,5,1,2,20,28,3,normal
22,3,6,2,1,28,37,3,normal
22,3,6,0,2,34,42,3,normal
23,3,5,0,2,24,31,3,normal
23,3,11,2,2,32,47,3,normal
23,3,5,2,2,37,46,3,normal
23,3,10,1,0,25,36,3,normal
